genotype,mean_height_px,median_height_px,min_height_px,max_height_px,height_range_px,area_px
PI548797,1221.0990196078433,1235,441,1495,1054,3733730
PI548797,1329.7807189542484,1348,863,1466,603,4064093
PI548797,1423.7271241830067,1467,630,1577,947,4343965
PI576356,1709.6291275930662,1723,1455,1803,348,4990875
PI576356,1715.9911764705882,1722,1179,1812,633,5237168
PI576356,1469.1130718954248,1471,1231,1587,356,4481002
SC1166,1567.963071895425,1630,1162,1767,605,4788535
SC1166,1342.6942013587045,1360,88,1498,1410,4064227
SC1166,1346.305958680818,1396,3,1557,1554,3722447
PI534038,640.7718954248367,641,271,824,553,1941271
PI534038,907.10442969414,938,684,1030,346,2767191
PI534038,1419.600628530665,1457,489,1637,1148,4326110
BTx378,1203.0934739894656,1156,480,1700,1220,2824817
BTx378,1302.8575163398693,1319,462,1454,992,3982094
BTx378,1053.1161031341671,1065,801,1138,337,2920267
PI655992,1332.8117647058823,1331,955,1466,511,4072763
PI655992,1103.7604747162022,1138,406,1250,844,3360174
PI655992,1175.2772261198056,1196,206,1297,1091,3588460
PI533855,1501.109548160535,1528,4,1676,1672,4047171
PI533855,1518.421568627451,1582,1098,1732,634,4641156
PI533855,1002.3101972713446,924,135,1814,1679,3037858
PI595736,1126.172549019608,1142,935,1218,283,3442123
PI595736,1711.6963700153738,1725,666,1831,1165,5215031
PI595736,1711.0022875816992,1728,1134,1881,747,5225222
PI533878,1733.3669934640523,1759,1497,1894,397,5297781
PI533878,1674.3519916223372,1686,777,1788,1011,5102502
PI533878,1388.0909379968202,1415,460,1682,1222,4136899
PI533890,716.1408800186741,736,181,824,643,2058857
PI533890,1060.8321349334842,1112,686,1305,619,3216064
PI533890,834.8649825515259,847,241,1003,762,2540716
PI534083,1028.266339869281,1045,809,1106,297,3144468
PI534083,1394.5390522074636,1414,5,1512,1507,4100135
PI534083,911.0252551595352,920,321,997,676,2776371
PI533800,1162.0901960784313,1167,983,1347,364,3541201
PI533800,1432.9915032679737,1448,1178,1617,439,4369232
PI533800,1696.9130718954248,1744,1203,1945,742,5191162
PI533763,950.8310938605364,994,3,1191,1188,2641389
PI533763,865.700622806323,873,379,975,596,2582721
PI533763,1030.5683006535949,1049,574,1096,522,3142523
PI534118,1782.0444444444445,1804,113,2089,1976,5444334
PI534118,1117.4259229644472,1234,146,1471,1325,3400751
PI534118,1918.026797385621,1952.5,1667,2126,459,5859192
PI595714,1044.0538378810159,1125,10,1181,1171,2693557
PI595714,1453.9640522875816,1481,715,1519,804,4442765
PI595714,1016.2791459609384,1049,388,1133,745,3092106
PI655974,682.6829528158296,668,555,1414,859,1968618
PI655974,1556.0885620915033,1542,1281,1747,466,4700009
PI655974,958.8667627015823,971,443,1065,622,2920479
PI533931,1178.4977124183006,1184,915,1313,398,3600266
PI533931,1346.5423543603206,1392,4,1533,1529,3714270
PI533931,1069.9143790849673,1102.5,632,1272,640,3260889
PI533822,1066.0411764705882,1081,889,1156,267,3261209
PI533822,846.2225490196079,857,630,988,358,2584558
PI533822,930.2958385653112,947,249,1069,820,2837457
PI534060,847.6062695738619,862,17,1060,1043,2247120
PI534060,920.016571700983,986,16,1198,1182,2595879
PI534060,1046.536274509804,1026,763,1248,485,3199752
PI533789,1492.2401960784314,1522,1211,1610,399,4563934
PI533789,1311.5908496732027,1371,987,1465,478,4001337
PI533789,1276.3993464052287,1293.5,567,1401,834,3892262
SC0965,1613.0617647058825,1634,1339,1707,368,4918281
SC0965,1110.6728758169934,1117,916,1226,310,3396176
PI595710,1360.688887540344,1462,635,1560,925,3579901
PI595710,1988.6450980392156,2001,1671,2252,581,6083305
PI595710,1151.6977124183009,1152,730,1270,540,3521607
PI576351,1528.9745098039216,1524,1283,1686,403,4670412
PI576351,1664.1506535947713,1656,1334,1874,540,5077459
PI576351,1759.9,1792,1481,1853,372,5376123
PI656077,791.5786014516823,837,44,911,867,2048017
PI656077,1394.7771241830064,1408,1135,1601,466,4260247
PI656077,1205.5163398692812,1261,822,1372,550,3678795
PI656010,97.40706331666917,93,17,173,156,19007
PI656010,1309.0918928175618,1409,2,1554,1552,2598730
PI656010,1566.8009803921568,1552,724,2667,1943,4763989
PI533843,953.0539215686274,1005,519,1110,591,2913914
PI533843,971.9104575163399,970,774,1077,303,2966785
PI533843,748.6400182713293,769,7,1046,1039,908565
PI533872,1223.9058823529413,1202,1075,1392,317,3741494
PI533872,1160.2522875816994,1158,607,1327,720,3506364
PI533872,1006.7512540648444,1009,460,1141,681,3040227
PI576410,1290.9259359490343,1350,406,1502,1096,3855976
PI576410,1158.7774509803921,1147,660,1959,1299,3533129
PI576410,943.3486928104575,954,688,1125,437,2884128
SC0921,1092.3264705882352,1077.5,875,1831,956,3330811
SC0921,1604.1855076938914,1573,765,2711,1946,4865093
SC0921,1417.1418300653595,1409,862,1614,752,4330375
PI534030,1181.3264705882352,1180,459,1377,918,3609010
PI534030,1132.1745098039216,1138,911,1230,319,3462054
PI534030,1378.696405228758,1424,1048,1622,574,4214969
PI534014,1439.1591503267973,1480,674,2185,1511,4388098
PI534014,1251.1820261437908,1260,1016,1359,343,3824799
PI534014,1716.2411764705885,1749,1477,1843,366,5244007
PI576363,867.58177357472,881,355,1155,800,2590248
PI576363,1090.036928104575,1109,483,1186,703,3327789
PI576363,1343.7939941330865,1354,622,1427,805,4101422
PI533975,1285.6529411764704,1295,1039,1428,389,3926486
PI533975,1164.104248366013,1149,933,1347,414,3560315
PI533975,990.0490196078431,964,870,1153,283,3025248
SC0631,1267.122549019608,1265,494,1432,938,3869889
SC0631,1026.125816993464,1032,730,1161,431,3139365
SC0631,1133.4653594771241,1173,576,1925,1349,3452551
PI656102,1009.1839869281047,1019,856,1105,249,3085055
PI656102,1386.9632805732736,1464,296,1638,1342,4135154
PI656102,1073.8202614379086,1111,596,1147,551,3283409
PI534127,1518.3233769924307,1560,618,1728,1110,4229025
PI534127,1022.8143790849674,1041,434,1110,676,3127322
PI534127,784.9764848829675,757,8,1858,1850,2128394
PI533956,1344.924183006536,1356,668,1544,876,4109952
PI533956,1176.8153594771243,1182,983,1327,344,3596996
PI533956,1659.4281045751634,1665,1291,1831,540,5069317
PI534055,1254.6911764705883,1254,482,1863,1381,3830350
PI534055,907.5132039639848,928,393,1017,624,2768440
PI534055,1006.0699346405229,992,597,1157,560,3073917
PI595727,1111.1660130718953,1130.5,896,1315,419,3398900
PI595727,1210.622549019608,1226,937,2025,1088,3694560
PI595727,903.4866013071895,923,604,1101,497,2744378
PI534109,495.188729030946,516,3,662,659,624627
PI534109,1447.5795284098247,1413,6,2417,2411,4080117
PI576403,1733.0505651117246,1732,211,1991,1780,5269035
PI576403,1775.8751633986926,1821,1215,2036,821,5418413
PI576403,1663.8845258191577,1668.5,659,1933,1274,5011660
PI152651,851.6329212844558,852,664,906,242,2366464
PI152651,1002.483193277311,1028,771,1143,372,2850750
PI152651,685.4590923204967,740,5,919,914,1442626
PI533881,337.95835755364544,344,4,566,562,439677
PI533881,759.400014290859,808,2,856,854,1158286
PI533921,694.0553179837337,750,3,874,871,619721
PI533921,724.1431815257099,762,2,893,891,998358
PI533921,1345.9155516550868,1486,2,1841,1839,1972123
PI655994,1178.967284723694,1335,150,1737,1587,2368530
PI655994,2085.2358199594764,2144,896,2326,1430,5507553
PI533923,829.3271808231956,872,3,1028,1025,1384019
PI533923,816.6510398242241,862,4,1013,1009,1068584
PI533923,957.7679124072887,986,5,1148,1143,2426916
PI576382,1901.0098039215684,1889,1266,2122,856,5735560
PI576382,1021.1807189542484,1042,498,1386,888,3103822
PI576382,1018.4277777777778,1039,489,1378,889,3094606
PI656007,1175.6538783620751,1253,2,1408,1406,2932305
PI656007,127.17347754039179,131,5,194,189,33022
PI656007,310.63505416691885,357,2,471,469,135992
PI595722,686.822315340939,749,2,832,830,978617
PI595722,1079.435545269235,1115.5,2,1248,1246,2000355
PI595722,688.3198060716215,733,3,816,813,1044979
SC0448,1444.3857379767828,1518,543,1782,1239,4356338
SC0448,1666.9166666666665,1669.5,931,1873,942,5079851
SC0448,1472.2793847991063,1496,626,1762,1136,4492129
PI533989,1291.7377291528537,1390,84,1487,1403,2724341
PI533989,1633.1129782189805,1669,3,1751,1748,3819705
PI533989,826.6300544882245,858,2,1011,1009,1479868
PI533898,117.46968085106383,130.5,4,156,152,15002
PI533898,531.8525182928945,573.5,2,673,671,621521
PI595730,1142.800260091869,1196,4,1323,1319,2412495
PI595730,1128.1554921917489,1183,25,1332,1307,2334772
PI595730,1235.1182810100577,1281,2,1464,1462,2541489
PI595730,1164.2935224792532,1271.5,2,1476,1474,3142569
PI595737,1401.7830065359476,1402.5,516,1599,1083,4149852
PI595737,1356.0659056795753,1405,2,1633,1631,2864561
PI595737,1491.0123676212465,1613,4,1754,1750,2047582
PI534047,813.8496042324152,948,3,1101,1098,738940
PI534047,647.1367788061627,697,2,789,787,1006243
PI533884,1287.4433680316868,1300,548,1462,914,3835817
PI533884,882.7870026889254,937,2,1176,1174,861580
PI533884,802.4723267875443,854,4,962,958,761459
PI533884,1045.8394377598174,1090,3,1171,1168,2402421
PI533919,1595.670148947821,1646,3,1791,1788,2441717
PI533919,551.8690360983103,609,2,729,727,533036
PI533919,1099.8130718954249,1122,412,1200,788,3361103
PI656032,1360.4767098341417,1437,2,1648,1646,2767317
PI656032,1139.9470017896829,1181,435,1232,797,3428338
PI656032,879.7335286814912,875,293,1038,745,2675013
PI534105,1022.8449792826061,1046.5,14,1159,1145,2595924
PI534105,1367.0109625304217,1406,4,1596,1592,3560555
PI534105,518.1465075565072,586,2,684,682,798094
PI533761,276.7843529847979,322.5,2,369,367,41688
PI533761,1734.3295705292892,1797,2,1951,1949,3951864
PI533761,1551.749570997913,1566,741,1737,996,4723578
PI576340,1225.6400401991455,1239.5,2,2206,2204,2557472
PI576340,1167.9088342628934,1181,3,1351,1348,1936667
PI576340,1211.2604755692487,1325,2,1445,1443,1360625
SC1021,593.0833479493701,652,2,751,749,561103
SC1021,1103.6049518919078,1162.5,3,1433,1430,1260298
SC1021,1606.9469295109502,1818,2,2028,2026,2524305
PI534058,689.8611461251166,712.5,356,752,396,1459518
PI534058,411.5071895424837,416,291,471,180,1025838
PI534058,773.4280457127627,793,3,891,888,2069836
PI595699,484.66129886737303,523,2,663,661,221056
PI595699,1520.0440187887314,1570,634,1719,1085,4070495
PI534051,1156.9095309154482,1193,9,1325,1316,2992790
PI534051,1453.9453741664397,1455,8,1652,1644,4127356
PI595706,648.8716025126873,699,2,784,782,549505
PI595706,1568.3477124183007,1588,1170,1757,587,4764842
PI595706,1723.1490161813963,1712,485,1955,1470,5233415
PI533955,838.7412875696683,926,2,1104,1102,885540
PI533955,1085.966861728346,1127,218,1244,1026,3214643
PI597970,1245.8128658011992,1302,384,1436,1052,3801855
PI597970,1088.1541168702909,1126,102,1207,1105,3204813
PI597970,990.1529411764706,1013,741,1161,420,3020880
PI534025,1872.2458200630517,1878,141,2046,1905,5630506
PI534025,2063.6952393002525,2120,596,2280,1684,6137694
PI534025,1863.8367895460544,1919,55,1992,1937,5366047
PI533797,235.51869034287847,263,3,323,320,77761
PI533797,1084.9249481327026,1140,2,1399,1397,1856702
PI533797,820.273439279987,868.5,2,1060,1058,1908638
PI533783,802.1465178601152,806,404,965,561,2202190
PI533783,809.4414757692125,851,3,945,942,1743125
PI533783,1346.1462513177312,1342,421,1585,1164,3511006
PI533783,1436.5646222531007,1451,883,2156,1273,4367513
PI576334,113.90065298507463,119,44,124,80,7527
PI576334,888.8500019280082,890,365,1001,636,2711176
PI576334,856.01402193931915,920,19,1306,1287,2306811
PI597963,1425.0086413326394,1454,524,1579,1055,4330284
PI597963,1217.270954046864,1259,318,1569,1251,3707517
PI597963,1240.4359477124183,1270.5,527,2295,1768,3701473
PI585295,830.8624624247623,869,2,1100,1098,1414500
PI585295,405.0581152486317,453,3,642,639,209099
PI585295,489.7652512400575,534,5,637,632,423452
PI533990,637.0111099597436,693,2,847,845,767473
PI533990,1638.4819231277088,1687,82,1778,1696,4939000
PI533990,800.474795751634,827,31,1036,1005,2358426
PI533952,1176.537008716827,1191,118,1363,1245,3305480
PI533952,1273.817320261438,1289,366,1467,1101,3889720
PI533952,1483.5480789798437,1538,2,1716,1714,4234123
PI534045,1110.928286501794,1112,15,1260,1245,2761413
PI534045,998.1652331461793,1028,190,1142,952,2667268
PI534045,829.769394189103,864,3,931,928,1475486
PI533752,120.3420554854981,140,5,152,147,16416
PI533752,1812.885846722605,1898,2,2052,2050,4401094
PI533754,1296.5966053961708,1355,557,1565,1008,3870186
PI533754,1231.6176470588234,1290,543,2051,1508,3742187
PI533754,1304.3130718954249,1434,207,1793,1586,3909637
PI534000,1290.7153594771241,1276,1130,1454,324,3702585
PI534000,1428.4843137254902,1489,912,1638,726,4359199
PI534000,2097.1901535839183,2121,28,2306,2278,6388811
PI597960,1655.8256431012771,1708.5,623,1938,1315,5039590
PI597960,1921.7887264570522,1932,614,2015,1401,5830857
PI597960,1066.998366013072,1064,875,1235,360,3260557
SC0266,1020.1493464052287,1003,687,1181,494,3110155
SC0266,1415.736928104575,1410.5,948,1680,732,4321779
SC0266,996.5009803921569,1003,591,1174,583,3030498
PI595733,1576.2173202614379,1599,483,1713,1230,4814878
PI595733,1985.0807189542484,2049,1398,2214,816,6065026
PI595733,1452.7026586942234,1449,618,2164,1546,4423647
SC0604,931.3254901960784,958.5,660,1109,449,2844778
SC0604,1241.3362745098038,1249,539,1421,882,3775134
SC0604,957.2693930290403,1001,247,1136,889,2901032
PI656031,1180.7297385620914,1204,620,1893,1273,3596895
PI656031,1011.1519607843137,1032,627,1167,540,3088841
PI656031,1238.5607843137254,1245,658,1348,690,3783854
PI576385,1317.9467320261438,1320,1013,1479,466,4021165
PI576385,935.1882352941177,952,702,1031,329,2859992
PI576385,1085.546227852006,1123,439,1168,729,3309383
PI656048,1524.0539215686274,1480,652,2325,1673,4437967
PI656048,1734.092156862745,1764,1328,1891,563,5290122
PI656048,1873.114360673847,1896,1612,1947,335,5491230
PI533766,1278.9783942720467,1317,5,1479,1474,3676221
PI533766,1368.8221926112565,1380,625,1475,850,4149180
PI656109,1214.075224280683,1320,2,1431,1429,1741978
PI656109,1021.2702614379084,1003,735,1173,438,3118149
PI656109,1357.831340352233,1364,516,1483,967,4138172
PI642992,1437.9746570989323,1424,570,2594,2024,4328116
PI642992,1231.6978307858576,1247,560,1392,832,3733285
PI642992,1380.048366013072,1408,312,1647,1335,4207619
SC0837,942.5588235294117,942,721,1080,359,2883487
SC0837,1478.94486036839,1448.5,1240,1690,450,4292266
SC0837,1167.0142047644745,1217,741,1373,632,3558636
PI595736,1863.7107843137255,1901.5,1649,2025,376,5694934
PI595736,1803.7127450980392,1825,1544,1906,362,5515213
PI595736,1874.5666666666668,1892,1622,1975,353,5717920
SC0235,511.1647967340414,548,3,654,651,466212
SC0235,1002.0414364295016,1059.5,2,1215,1213,960097
SC0235,891.9250285750988,925,2,1062,1060,1684246
PI534019,952.2379084967321,965,721,1188,467,2904660
PI534019,1098.4701259200683,1101,506,1315,809,3215500
PI534019,1070.7027081200747,1126,2,1211,1209,1966505
SC0615,1087.410685695043,1065,533,1220,687,3270184
SC0615,1325.033660130719,1348,563,1513,950,4048903
SC0615,1321.0477124183008,1344,557,1499,942,4037294
PI534069,1032.459477124183,1037,697,1159,462,3155013
PI534069,1542.9049019607842,1608,1250,1745,495,4708148
PI534069,1226.0555555555557,1223,583,1488,905,3746395
PI533843,1248.309101418345,1298.5,372,1414,1042,3552031
PI533843,1076.166339869281,1078.5,803,1170,367,3289042
PI533843,1324.2911210812008,1346,592,1487,895,3994537
SC0581,1020.072578728461,1041,281,1090,809,2889028
SC0581,991.4125059911064,1003,158,1177,1019,3018920
SC0581,1650.7366013071896,1643,605,1824,1219,5039391
PI561072,1124.6660130718956,1156,451,1263,812,3439367
PI561072,1300.736928104575,1322.5,657,2171,1514,3959006
PI561072,1518.6718954248365,1567,1119,1657,538,4641319
PI597951,909.2488027947873,972,3,1054,1051,1360889
PI597951,1218.5251633986927,1242,876,1910,1034,3723013
PI534123,1640.7770896178984,1712.5,741,1776,1035,3628866
PI534123,1192.388923585589,1204,2,1364,1362,3186525
PI534123,1064.6856209150328,1095.5,771,1216,445,3254932
PI576360,1051.4908496732025,1066,790,1172,382,3188492
PI576360,1560.05522875817,1595,1188,1715,527,4766205
PI576360,1486.9689542483661,1505,1245,1579,334,4546758
SC0190,2077.5833333333335,2129,1362,2280,918,6272809
SC0190,1627.3928104575161,1596,818,1911,1093,4968555
SC0190,1783.4333333333334,1829,887,1950,1063,5407073
SC0178,931.0798102236938,980,179,1226,1047,2242443
SC0178,1811.9216213367067,1797,687,2205,1518,4120121
SC0178,241.8633453068874,252.5,2,315,313,63227
PI655978,989.890638019885,1007,3,1182,1179,2111380
PI655978,945.1573928963312,976,389,1065,676,2477700
PI655978,1313.1287421189825,1355,646,1529,883,4009041
PI534016,1690.9741830065361,1721,1224,1850,626,5158093
PI534016,1286.6013071895425,1312,1093,1407,314,3926200
PI534016,1637.0775926605188,1708,593,1893,1300,4990502
PI533775,1233.3026143790848,1270,775,1382,607,3751526
PI533775,1181.7368568995503,1217,285,1352,1067,3380305
PI533775,1114.322222222222,1079,843,1296,453,3396121
PI597973,1389.168942207822,1415,406,1519,1113,3952850
PI597973,1373.8316993464052,1338,1207,1639,432,4202336
PI597973,1161.7264705882353,1161,867,1307,440,3547243
PI533939,1392.2355642772432,1431,27,1583,1556,3799668
PI533939,837.5058446455505,856,407,955,548,2169779
PI533939,1048.8245098039215,1052,782,1231,449,3201430
PI576433,1742.0293921638631,1759,723,1915,1192,5075727
PI576433,1962.7192723168264,2009,349,2212,1863,5756451
PI576433,1314.0588769709525,1349,110,1458,1348,3759457
SC1178,939.0774509803922,937,740,1086,346,2870521
SC1178,977.726759941575,980,4,1113,1109,2041154
SC1178,1083.9275970300218,1102,433,1274,841,3189648
PI534008,1142.0091482591483,1164,3,1229,1226,3412981
PI534008,1335.5123803034967,1343,613,1479,866,4000618
PI534008,850.6547014038982,850,191,1093,902,2554394
PI533934,1231.3359477124184,1270,546,1364,818,3765654
PI533934,1519.7,1551,1338,1615,277,4634432
PI533934,1550.5986928104574,1530,1196,1747,551,4736134
PI576398,1731.0005189353783,1776,20,1864,1844,4724238
PI576398,1740.3075959525918,1805,724,1918,1194,5308114
SC0179,1183.3303159870475,1218,3,1406,1403,2799897
SC0179,1508.1288228333815,1495.5,609,1768,1159,4450766
SC0179,985.611058952549,1027,2,1188,1186,2713987
PI534129,1622.2674125663648,1666,4,1867,1863,4011860
PI534129,1632.0838136193402,1663,70,1869,1799,4054320
PI534129,1792.9841454012799,1836,714,1963,1249,5468950
PI534129,1565.5554979136007,1598,10,1764,1754,4332114
PI533994,1407.620112397944,1425,587,1565,978,4036767
PI533994,1526.229411764706,1564,433,1832,1399,4660466
PI533994,1514.391957037592,1545,23,1630,1607,4287729
PI533897,781.2467634107475,849,2,914,912,1019025
PI533897,953.1519918209369,953,407,1227,820,2896662
PI533897,1259.8911736737705,1214,441,1492,1051,3828638
PI533916,642.8263346991904,671,2,712,710,1107100
PI533916,688.7298463971966,726,2,789,787,1534676
PI533916,697.1865832610019,728,2,823,821,1131356
SC0868,1023.2582418043976,1036,450,1163,713,2950931
SC0868,1661.0883483588964,1733,4,1856,1852,3964112
SC0868,972.5739176610858,965,6,1625,1619,1312169
PI534114,1022.322377514198,1045,473,1160,687,2709780
PI534114,1204.1767363920028,1223.5,558,1301,743,3676171
PI534114,983.6015179400717,996,334,1088,754,3001092
PI534109,1644.535780140478,1673,688,1828,1140,5010878
PI534109,1372.9474178403757,1468,2,1578,1576,1979392
PI534109,1688.4921461550982,1729,882,1794,912,5152316
PI533793,2026.4359477124185,2061,724,2189,1465,6181733
PI533793,1382.1656862745099,1360,1038,1649,611,4220889
PI533793,1952.277038973455,2008.5,562,2167,1605,5941889
PI585295,1461.5606983539014,1514,581,1607,1026,4455765
PI585295,1180.105000317279,1212,427,1269,842,3425281
PI585295,1368.4153594771242,1381,1081,1451,370,4176485
PI533890,668.9129518844446,675,243,827,584,1965603
PI533890,906.179411764706,934,680,1045,365,2770154
PI533890,1018.3016326758052,1032,418,1133,715,3057533
SC0741,1073.0874687561375,1096,3,1208,1205,2180324
SC0741,1572.8775978893086,1600,560,1731,1171,4787801
SC0741,1604.1745098039216,1599,652,1856,1204,4808235
PI533772,958.5427335347699,1028,2,1136,1134,1581575
PI533772,881.4925674598558,908,279,1115,836,2676403
PI533772,1045.578431372549,1064,851,1229,378,3196784
PI595740,1574.5349673202613,1597,1435,1692,257,4813726
PI595740,1544.108823529412,1563,1318,1629,311,4721527
PI595740,1579.0993464052287,1602,1396,2357,961,4824604
PI534134,1536.2375816993463,1484.5,1201,2515,1314,4679777
PI534134,1730.6183006535948,1729,1492,1893,401,5275160
PI534134,1534.9928104575165,1549,673,1627,954,4672366
PI534161,1437.3431294308425,1518,3,1632,1629,3045100
PI534161,1736.0809941502384,1810.5,4,1963,1959,4438039
PI534161,1587.7029411764706,1605,1160,1814,654,4846346
PI533798,1048.414729653368,1112,4,1278,1274,2076660
PI533798,1247.4400293685758,1318,83,1463,1380,611367
PI533798,1627.8942252313468,1651,741,1763,1022,3754788
PI534014,1379.7769218626277,1439,2,1577,1575,3321850
PI534014,1580.0460784313725,1601,1316,1687,371,4830620
PI534014,1168.592822389442,1194,7,1328,1321,3509564
PI533882,1505.1343137254903,1509,781,1702,921,4597425
PI533882,1709.63431372549,1697,1203,1875,672,5212988
PI533882,1788.35522875817,1895,854,2062,1208,5457903
PI576378,1741.523202614379,1756.5,1402,1923,521,5325489
PI576378,1182.4910885238025,1182,398,1304,906,3608111
PI576378,1132.0127450980392,1136,877,1290,413,3456882
PI533908,1308.6427853938872,1344,618,1475,857,3334803
PI533908,1395.7165505957735,1412,625,1575,950,4253976
PI533908,1448.0426692965154,1441.5,335,1593,1258,4401445
PI534117,946.3096298763733,1013.5,3,1125,1122,1173855
PI534117,1265.2245098039216,1264,979,1531,552,3852927
PI534117,1299.7153594771241,1336,792,1782,990,3944510
PI595716,1379.756060839529,1433.5,261,1569,1308,4207539
PI595716,1242.588433427744,1301,489,1386,897,3791904
PI595716,1467.7075163398695,1465,1158,1643,485,4479646
PI534076,752.3795322763328,807,2,932,930,1432994
PI534076,1014.2176470588236,1024,445,1133,688,3098975
PI534076,1154.028431372549,1242,212,1471,1259,3460070
PI642998,830.93954248366,826,21,1017,996,2538133
PI642998,268.57039526996607,260,61,337,276,485244
PI642998,666.8098039215686,650,471,947,476,2013325
PI534028,1311.2591736205068,1329,10,1525,1515,3923935
PI534028,1379.6302747844597,1468,514,1598,1084,4198940
PI534028,1318.9068627450981,1319,832,1571,739,3985883
PI533999,663.1320261437909,680,359,795,436,2028072
PI533999,1223.3506535947713,1182,796,1506,710,3725785
PI533999,1473.4988710635769,1502,431,1611,1180,4266461
PI597960,1007.2088873993089,1108,2,1217,1215,1421921
PI597960,1442.5253685359628,1383,3,1795,1792,3796737
PI597960,107.55934439891658,116,3,159,156,12844
PI533906,624.3608508845091,650,2,839,837,953357
PI533906,1312.536375511485,1350,3,1557,1554,3579570
PI533906,982.417876821221,931,387,1415,1028,2832142
PI597968,218.15406623113313,221,8,390,382,30069
PI533838,792.8219505528562,857,3,1008,1005,1062168
PI533750,543.2858151241699,575,9,696,687,744892
PI533750,156.54517464955387,169,14,198,184,44400
PI595744,257.4457777777778,270,3,402,399,123831
PI595744,322.81214162411425,360,3,430,427,152853
PI595744,199.61183844261265,218,4,252,248,46426
PI595744,1004.6310700585504,1078,4,1183,1179,1312569
PI656093,404.11775752554547,414,8,506,498,227597
PI656093,193.52859137449582,211,2,254,252,94763
PI656093,1220.8566467264873,1218,378,1409,1031,3627100
PI533823,991.0996732026144,1027,777,1134,357,3030350
PI533823,1009.2692810457515,1026,783,1182,399,3083137
PI533823,1320.7287581699347,1351,513,1834,1321,4020023
PI576417,804.7015011454376,819,251,957,706,2284324
PI576417,976.1565590610835,967,88,1666,1578,2842129
PI576417,1016.17358234885,997,14,1387,1373,2638291
PI595735,1513.181045751634,1555,1174,2269,1095,4516038
PI595735,1355.6626176392492,968,3,2053,2050,1900548
PI595735,1502.130200976616,1529,649,1593,944,4554286
SC0371,965.0170087996117,1027,4,1127,1123,2589389
SC0371,1324.8211803614388,1478,2,1589,1587,2922229
SC0371,1028.9679572501066,1065,2,1220,1218,2585843
SC0458,294.39518702182625,298.5,2,448,446,602049
SC0458,768.8793397984947,787,68,916,848,2109613
PI533873,1122.9764705882353,1124,893,2261,1368,3387719
PI533873,1462.8496732026144,1522,1104,1679,575,4464540
PI533873,1236.8462032954558,1283,553,1348,795,3577532
PI656098,844.1990196078432,873,494,983,489,2577093
PI656098,981.03612907033,989,69,1125,1056,2836746
PI656098,1039.7174590576683,1061,549,1179,630,2958105
PI24969,625.9320235450045,676,299,1615,1316,1737113
PI24969,541.4039215686274,544,384,683,299,1647956
SC0860,1762.690791666936,1819,837,2031,1194,5208418
SC0860,1577.6323529411764,1666,734,2916,2182,4715412
SC0860,894.8182449406138,864,354,1161,807,2661290
PI597972,1437.215377214667,1482,771,1677,906,4287503
PI597972,1297.592156862745,1349,962,1469,507,3966795
PI597972,1168.1084967320262,1188,957,1299,342,3570725
PI534135,1512.3330065359478,1533,1328,1707,379,4574013
PI534135,1459.3444444444444,1449,1154,1708,554,4463816
PI534135,1763.0790849673203,1806,1319,1950,631,5391082
PI576365,1227.455574098959,1288,394,1562,1168,3473337
PI576365,961.0192810457518,980,802,1048,246,2940233
PI576365,1043.4692810457518,1068,789,1325,536,3185860
PI533988,723.9303921568627,815,115,964,849,2194062
PI533988,1665.4250822613137,1718,742,1802,1060,5063950
PI533988,1815.1375816993464,1847.5,1191,1992,801,5545928
PI534100,971.0439505908181,1035,2,1304,1302,2284030
PI534100,1708.824937688574,1738.5,6,1911,1905,4765462
PI534100,1645.3506985790268,1598,704,1983,1279,4935471
PI655987,1571.64477124183,1593.5,1079,1861,782,4799360
PI655987,1494.4267093893422,1548,526,1753,1227,4480829
PI655987,1532.0019607843137,1535,1330,1666,336,4650271
PI533968,1282.7402599821455,1311,625,1873,1248,3912972
PI533968,1258.3345276292334,1272,470,1419,949,3803319
PI533968,1149.3965981129295,1251,3,1339,1336,2587325
PI534069,958.2174974611926,986,4,1133,1129,2211938
PI534069,982.0452002649947,1037,21,1110,1089,2177149
PI534069,469.559761626998,511,23,552,529,916811
PI534002,859.7003334984671,854,310,1086,776,2421698
PI534002,1109.152614379085,1129,934,1236,302,3391521
PI597945,1020.9117647058823,1045,814,1148,334,3059339
PI597945,1266.0395424836602,1266.5,748,1810,1062,3859341
PI597945,1122.1264705882354,1137,975,1218,243,3431209
PI595708,1185.486928104575,1197,990,1292,302,3623481
PI595708,885.1875816993464,906,685,967,282,2707946
PI597981,189.34982174688056,226,7,255,248,23203
PI597981,493.0517860758894,502,108,748,640,1484652
PI534153,1305.8929014145479,1352,81,1497,1416,3795684
PI534153,1491.3616678770272,1468,721,1784,1063,4350300
PI534153,750.0105863506885,766.5,4,944,940,1375348
PI656046,1714.6581699346407,1763,1365,1878,513,5226309
PI656046,1447.8568627450982,1445,1222,1636,414,4420108
PI656046,969.4761437908496,978,737,1192,455,2941172
PI597947,974.891503267974,969,772,1143,371,2975577
PI597947,1021.3238562091503,994,846,1134,288,3122690
PI597947,1121.2460784313726,1157,842,1286,444,3424439
PI533759,1884.8934640522875,1948,365,2079,1714,5736526
PI533759,1637.2264705882353,1681,1409,1803,394,4989733
SC0652,935.5471677559913,1010,353,1172,819,2718480
SC0652,630.9274509803921,625,277,848,571,1926601
SC0652,1037.3032679738565,1076.5,499,1260,761,2890998
PI576374,1542.6248366013072,1573,1343,1650,307,4720432
PI576374,1461.2460784313726,1473,532,1585,1053,4406936
PI576374,1623.0084967320263,1623,1463,1727,264,4964632
PI656105,1241.0709150326797,1256.5,935,1350,415,3788122
PI656105,1252.9513071895426,1301,249,1682,1433,3818597
PI656105,1224.8591503267974,1257.5,518,1345,827,3732632
PI534121,654.1695994700608,703,2,847,845,1003181
PI534121,1134.093790849673,1151,466,1241,775,3448954
PI534121,1029.251282185017,1046,2,1199,1197,2688138
PI533841,1463.964705882353,1489.5,1152,1614,462,4473384
PI533841,1223.9797385620914,1245,724,1388,664,3737703
PI533841,1538.48841228625,1529,721,1777,1056,4528217
PI533920,1680.066339869281,1659,889,2019,1130,5020496
PI533920,1621.8287581699346,1671,1358,1783,425,4958390
PI533920,1267.6950980392157,1291,991,1449,458,3876225
PI533772,2081.3398948223244,2448.5,542,2722,2180,4239914
PI533772,759.5032679738563,765,553,919,366,2310633
PI533772,939.1516443280864,1002,2,1108,1106,2113321
PI533962,1007.4964052287582,1009,834,1095,261,3078286
PI533962,1012.2571895424836,1021,802,1155,353,3094355
PI533962,1181.56045751634,1185,969,1243,274,3612133
PI595703,1439.5941176470587,1438.5,1198,2166,968,4396483
PI595703,1260.533660130719,1299,908,1454,546,3849813
PI595703,953.2005399261154,941,720,1141,421,2551843
SC0871,1031.347117203165,1132,3,1251,1248,2127594
SC0871,1360.903704728695,1452,2,1610,1608,3084857
PI533817,1751.720736643281,1860,132,1982,1850,4859720
PI533817,979.4996732026144,984,556,1124,568,2985973
PI533817,1359.1124183006536,1392,938,1503,565,4144933
PI533847,849.5093839504043,892,17,973,956,2589682
PI533847,692.0052750520368,709,3,864,861,1487819
PI533847,853.5045751633987,845,671,1010,339,2610070
PI533976,1742.454248366013,1770,1526,1887,361,5324310
PI533976,1576.7398692810457,1643,1075,1759,684,4820597
PI533976,1710.0238562091504,1735,1410,1826,416,5226421
PI576414,1353.8005601537127,1401,3,1610,1607,3336959
PI576414,1584.2659828838673,1675,2,1857,1855,3536918
PI576414,739.4284313725491,760,499,871,372,2261622
PI576378,1075.6238562091503,1087,886,1239,353,3288550
PI576378,1075.8045751633986,1099,875,1237,362,3277092
SC0027,1510.6398692810458,1482.5,1143,1803,660,4602608
SC0027,1101.9836601307188,1115,898,1349,451,3367013
SC0027,1414.9882745463176,1453,301,1674,1373,4087823
PI534080,1384.3932785726904,1408,1236,1428,192,3982851
PI534080,738.6486928104575,795,431,890,459,2232147
PI534080,803.9198858647937,830,321,886,565,2431227
PI534080,842.0128512931321,902,18,975,957,1924420
PI534080,894.0532768027344,914,9,1017,1008,2097840
PI642793,1473.620191440571,1585,466,2273,1807,3846872
PI642793,980.8033386443262,995,595,1149,554,2990771
PI642793,1228.506862745098,1177,869,2103,1234,3637537
PI656024,1563.6553491572067,1600,1129,1737,608,4260986
PI656024,1476.1808080808082,1488,1323,1533,210,4274266
PI656024,1375.861111111111,1379,1195,1461,266,3970098
PI533842,1743.2349673202616,1784,779,1902,1123,5318061
PI533842,1370.5189542483658,1384,1047,2231,1184,4146328
PI533842,1649.248366013072,1664.5,801,1858,1057,5036937
PI533814,1380.329916815211,1380,559,1526,967,3979719
PI533814,1448.1323529411766,1498,320,1627,1307,4424757
PI533814,1068.858823529412,1116,776,1171,395,3031875
PI576385,871.5709909952682,876,631,1014,383,2382364
PI576385,1203.6651332327804,1199.5,997,1284,287,3443180
PI576385,1051.5052958947929,1059,436,1222,786,2976794
PI534150,974.528299490634,1005,19,1327,1308,2641500
PI534150,1055.76045751634,1053,909,1191,282,3224339
PI534150,993.3567914045443,999,419,1072,653,2836890
SC0837,1067.9267219708395,1085.5,906,1216,310,3029712
SC0837,1127.1859477124185,1168,804,1521,717,3422763
SC0837,1620.2583465270168,1654,600,1850,1250,4789955
SC1119,1446.0310457516339,1417,1169,1654,485,4418553
SC1119,1522.4705882352941,1581,1078,1716,638,4573533
SC1119,654.275600253058,714,3,813,810,1490156
PI534015,1457.972170970693,1455,633,1662,1029,4362593
PI534015,1520.076797385621,1533,1224,1676,452,4647383
PI534015,1781.2645919133836,1768,869,2086,1217,5356682
PI533860,1073.3306305353358,1107,3,1306,1303,2720751
PI533860,1821.689869281046,1835,1231,1960,729,5559534
PI533910,1265.332679738562,1280,964,2007,1043,3864538
PI533910,1384.6908496732026,1398,1170,2162,992,4230317
PI533910,1114.8627804101338,1150,473,1283,810,3399954
PI534013,1626.291503267974,1646,1011,1795,784,4964281
PI534013,1519.55153643547,1547,950,1702,752,4402801
PI534013,1881.275163398693,1869,1328,2103,775,5754777
PI656041,1284.4045751633987,1309,1053,1994,941,3924230
PI656041,1288.0359477124184,1313,1110,2006,896,3933297
PI656041,1637.2029411764706,1692,1209,1810,601,5003310
PI656041,1844.5359477124182,1864,1357,2212,855,5296023
PI533933,1661.624183006536,1657,810,1935,1125,5080099
PI533933,1486.7323529411765,1491,976,1689,713,4491047
PI533933,1237.4075163398693,1223,906,1431,525,3780833
PI533997,1079.5111111111112,1086,780,1316,536,3278032
PI533997,880.6915032679738,881,721,971,250,2693789
PI533997,741.6715686274509,739,367,945,578,2266484
PI534018,1176.441057929614,1226,357,1433,1076,3527916
PI534018,1372.4839869281045,1392.5,142,1679,1537,4192048
PI534018,1158.6133986928103,1239,398,1473,1075,3506040
PI534018,1662.1055555555556,1706,1285,1805,520,5078075
PI533770,1088.6195296028648,1132,5,1352,1347,3153820
PI533770,989.3683282980866,982,500,1191,691,2941439
PI533770,681.6317566798743,778,4,931,927,1565528
PI533827,1585.1692810457516,1668,1012,1874,862,4842787
PI533827,1504.0937908496733,1578,625,1647,1022,4570642
PI533827,1089.3029411764705,1119.5,694,1277,583,3329326
SC0314,955.874231782265,938,796,1069,273,2691934
SC0314,868.0156862745098,863,505,1129,624,2644321
SC0314,967.0285068391631,1004,4,1157,1153,2692212
PI533812,1094.0607843137254,1006,498,2099,1601,2957867
PI533812,1279.9957767722476,1293,1070,1419,349,3669357
PI533812,1191.700980392157,1208,568,1357,789,3625731
PI656068,1598.1718954248365,1617,295,1746,1451,4883789
PI656068,1210.7265242415372,1208,1005,1324,319,3466845
PI656068,1339.5049316696375,1330.5,987,1483,496,3857759
PI601816,1420.0343263587579,1446,7,1703,1696,3596265
PI656055,1440.0103550007655,1463,643,1618,975,4216517
PI656055,1463.5424836601308,1470,615,1619,1004,4473297
PI656055,1663.0824973997458,1686,738,1831,1093,5076772
PI656055,1665.3582185314349,1688,1301,1832,531,5082586
PI533925,1269.328656251743,1310.5,497,1424,927,3570724
PI533925,1560.0356195920072,1613,15,1757,1742,4534056
PI533925,1768.8590173731163,1787,769,1979,1210,4937613
PI655972,1340.8843137254903,1370,982,1452,470,4086023
PI655972,1602.883660130719,1577,731,1859,1128,4889375
PI655972,1615.0970588235293,1699,761,1889,1128,4921766
PI533840,809.6699025744449,822,2,926,924,1440824
PI533840,1058.9013071895424,1063,672,1299,627,3235275
PI533840,905.8162025743277,909,8,1057,1049,2705311
PI533836,748.3261021729708,752,373,959,586,2261902
PI533836,1374.774183006536,1373,1157,1549,392,4199110
PI534124,1369.0538137591805,1381,516,1492,976,3941885
PI534124,1359.2301737910116,1394,401,1491,1090,4000908
PI534124,1588.7216746157924,1613,1231,1736,505,4316955
PI534059,1352.2225490196079,1343,871,1537,666,4133062
PI534059,1004.931045751634,1011,543,1144,601,3059878
PI534059,917.6784313725491,916,510,1165,655,2798313
PI533918,1938.9624183006536,1973,1580,2036,456,5694718
PI533918,1173.358728126334,1191,92,1263,1171,3346941
PI533918,1731.888888888889,1758,948,1883,935,5280540
PI533960,1011.7746103569632,1059,676,1271,595,2854885
PI533960,1414.5480392156862,1462,788,1677,889,4322785
PI533960,1856.965644487303,1853,791,2160,1369,5642494
PI534085,428.9505428376806,463,51,745,694,905195
PI534085,1301.6344242563741,1312.5,540,1947,1407,3703669
PI534085,584.6809484077319,587,6,757,751,1483470
SC0615,889.7509060389883,1018,12,1074,1062,1754786
SC0615,1173.635294117647,1188,489,1271,782,3584227
SC0615,916.7009647058824,957,7,1100,1093,2009252
SC0753,878.1264705882353,898,744,1008,264,2683616
SC0753,1554.2090478977661,1533,165,2039,1874,4496854
SC0753,1302.7643790849675,1338,980,1442,462,3978187
PI576328,1455.9725490196079,1508,605,1631,1026,4408050
PI576328,1322.0664286479619,1329.5,1096,1425,329,3834042
PI564164,1385.1901960784312,1389,1092,1560,468,4236141
PI564164,1553.9924836601308,1616,943,2324,1381,4739366
PI564164,1607.7183006535947,1612,1242,1754,512,4902123
PI597944,1626.7522543394707,1650,215,1825,1610,4497793
PI597944,1592.2928104575162,1616,947,1786,839,4860139
PI597944,1724.491230933725,1747,2,1995,1993,4234858
PI576347,408.5857828481511,414,2,610,608,312787
PI576347,118.0467229072031,114,20,172,152,7864
PI576347,928.8898797996126,976,8,1099,1091,2063540
PI576347,96.22222222222223,92,37,116,79,5709
PI534097,1363.9866013071894,1362,1158,1529,371,3931816
PI534097,788.3934640522876,770.5,420,979,559,2399839
PI534097,1248.268552036199,1248,279,1344,1065,3580767
PI651496,1331.1888952831562,1355,19,1470,1451,3663295
PI651496,106.6080885893115,114,11,124,113,6922
PI651496,392.21126078706595,431.5,2,590,588,200660
PI595738,1148.1094771241828,1135,900,1366,466,3510079
PI595738,1558.1300653594772,1552,1258,1799,541,4766766
PI595738,1756.2081699346404,1764.5,1478,1958,480,5349418
SC0814,1893.4349673202614,1946.5,1126,2337,1211,5735071
SC0814,1127.1973604826546,1140,959,1267,308,3201552
SC0814,1750.616993464052,1803.5,1027,1987,960,5298155
PI533899,725.5014865262348,787,5,897,892,391824
PI533899,380.4951540996317,451,37,468,431,134274
PI533910,922.65607057784,983,14,1076,1062,2434134
PI533910,1482.4424836601306,1488,1259,1578,319,4519365
PI533910,1656.4594771241832,1697,1356,1821,465,5052940
PI534108,844.171361066019,884,3,1028,1025,998864
PI534108,307.7863144905394,337,4,373,369,192796
PI548797,1044.116015274034,1107,2,1240,1238,2396977
PI548797,1396.0797385620915,1411,610,1606,996,4260169
PI548797,1658.4424836601306,1718,941,1782,841,5068432
PI542406,1218.673202614379,1225,1081,1289,208,3485786
PI542406,876.641912984099,905,666,940,274,2446704
PI542406,1279.0690322895327,1335,710,1377,667,3666304
PI533831,1327.3123524538667,1412,2,1543,1541,3026932
PI533831,963.1757228620436,1119,2,1195,1193,578442
PI576395,667.3216607737712,741,4,845,841,642496
PI576395,594.4828747894442,643,2,766,764,893415
PI533804,65.25369310129811,60,2,108,106,18528
PI533804,100.04761904761905,100.5,16,117,101,6081
PI656035,945.7950980392158,959.5,638,1126,488,2877165
PI656035,815.2104575163398,826,417,1041,624,2455340
PI656035,1032.395751633987,1042,746,1153,407,3152947
PI533846,802.9885693687902,792,2,1020,1018,1625708
PI533846,483.5225863739102,584.5,2,690,688,310088
SC0858,77.71373248570725,73,2,184,182,52639
SC0858,1000.2504055258258,1057,2,1111,1109,2557064
SC0858,373.1614155592056,411,5,463,458,90514
PI534004,1831.9166666666665,1894.5,1485,2011,526,5587539
PI534004,1351.8274509803923,1379,926,1520,594,4122525
PI534004,1373.5088235294118,1229,79,2899,2820,3728553
PI533944,1204.6830523646768,1217.5,423,1391,968,3673316
PI533944,952.8134210256898,1105,5,1258,1253,1057826
PI533944,819.1086974977298,846,95,973,878,2482822
PI534064,919.6777777777778,934,749,1030,281,2811913
PI534064,1049.6039215686274,1074,796,1152,356,3210085
PI534064,732.0854259586524,730,292,822,530,2146351
PI597963,1266.9958403207775,1324,435,1435,1000,3443930
PI597963,1659.3311295281362,1772,32,1938,1906,4476729
PI597963,1368.739112873614,1378,586,1566,980,3692443
PI533833,898.4457516339869,899,258,1105,847,2685832
PI533833,1024.0235724249496,1051,414,1151,737,2496231
PI533833,1230.0073250125197,1225,451,1370,919,3743602
PI656003,952.8415032679738,950,661,1113,452,2872736
PI656003,1099.8032679738562,1100,762,1226,464,3358288
PI24969,1183.4882352941177,1194,285,1369,1084,3610366
PI24969,700.1775401069519,712,558,754,196,1908706
PI24969,1703.6343137254903,1778,975,1944,969,5181277
PI534144,1392.8699346405228,1411,1190,2279,1089,4248954
PI534144,1525.066339869281,1541,1290,1686,396,4654610
PI534144,1108.0525454218387,1074,506,1302,796,3373844
PI533979,1078.7918300653594,1094,258,1265,1007,3239383
PI533979,1502.756862745098,1546,391,1987,1596,4547239
PI533979,828.4222222222222,843,447,1000,553,2496500
PI534018,1216.2411764705882,1244,578,1826,1248,3711987
PI534018,1173.4525042947694,1148,400,1623,1223,3269672
PI576333,1314.760473342451,1330,29,1454,1425,3826263
PI576333,1320.0019233170974,1363,218,1486,1268,3943416
PI576333,1348.7545751633988,1361.5,527,2016,1489,4100388
PI655992,1358.8053688785026,1410,8,1458,1450,3103700
PI655992,965.9550994028864,1004,4,1252,1248,2069633
PI655992,1212.2232029390996,1230,2,1412,1410,2933175
PI533891,898.6405228758169,889,701,1092,391,2747097
PI533891,1000.2114379084967,1035.5,793,1132,339,3059894
PI533891,1092.5467320261437,1087,709,1930,1221,3332597
PI656022,926.7388888888888,945,442,1112,670,2739523
PI656022,1046.6101307189542,1076,626,1374,748,3182230
PI656022,509.75830147649225,436,2,823,821,988493
PI534163,1298.8771245113057,1365,23,1582,1559,3684204
PI534163,1112.956467296124,1149,5,1318,1313,3048359
PI534163,1202.380628551725,1245,484,1353,869,3616440
PI656087,1444.9669046961508,1508,549,1756,1207,3589429
PI656087,1755.9808518561322,1791,542,1985,1443,5356429
PI656087,859.2686274509804,927,177,1074,897,2536963
PI534088,992.3287808282842,1049,2,1147,1145,1982502
PI534088,961.3483660130719,956.5,722,1137,415,2929069
PI534088,1035.3409011941553,1077,2,1203,1201,2941869
PI576332,1010.8246740187917,1038,394,1165,771,2513493
PI576332,1090.7620767099706,1115,534,1250,716,2879932
PI576332,917.5516966280738,930,2,1214,1212,1155605
PI576376,595.6931063505215,648.5,2,769,767,416395
PI656014,1150.0379084967321,1241,703,1357,654,3514935
PI656014,890.4415072052918,894,37,1101,1064,2597752
PI656014,1398.2375816993463,1426,970,1566,596,4256012
SC0201,508.5849844356728,560.5,2,673,671,449988
SC0201,234.16535615171136,279,5,335,330,39500
SC0201,960.7919491028988,1031,5,1199,1194,2097206
PI533941,1083.8133676114421,1137.5,6,1312,1306,2538663
PI533941,1417.716339869281,1466,1058,1610,552,4324308
PI533941,928.2467320261437,933,681,1022,341,2816796
PI533835,1008.7237536056516,1074,3,1150,1147,1257415
PI533835,1636.5440082518421,1743,722,1904,1182,3387497
PI533835,1478.4325552165428,1520,2,1594,1592,3680353
PI533801,1387.1237660818715,1402,4,1572,1568,2867308
PI533801,850.365435097318,874,2,975,973,1930636
PI533801,563.8890013495277,592,2,658,656,870436
PI533935,73.25147058823529,84,2,105,103,11734
PI533935,103.54621819449285,106,2,167,165,30034
PI534013,1271.4707402269373,1313,4,1458,1454,3227202
PI534013,1012.3430525786563,1054,342,1167,825,2808172
PI533778,221.70150978834067,254,3,289,286,25102
PI533778,898.2733871930498,982,2,1061,1059,2256296
PI534103,900.7243199810416,1005.5,2,1096,1094,1154857
PI533770,599.980808641998,672,2,749,747,382591
PI533770,1093.4785761324347,1185,5,1310,1305,1324766
PI533770,1286.5328853624753,1311,2,1472,1470,3357987
PI597976,1017.726797385621,1040.5,750,1139,389,3109622
PI597976,423.175591985428,483,2,581,579,292021
PI597976,141.7354865547048,166.5,2,198,196,51658
PI533796,208.45314714714715,222,2,307,305,123283
PI533796,887.5144720258644,987,2,1034,1032,779699
PI533850,1727.4669934640524,1718,1356,1874,518,5254916
PI533850,1653.724183006536,1739,862,2018,1156,5053928
PI533850,1106.624183006536,1154,424,1583,1159,3364941
PI533749,1136.3723911192317,1147,519,1297,778,2474110
PI533749,1092.0276237204455,1120,12,1201,1189,1374504
PI533749,1227.5711511789182,1338,3,1379,1376,1054151
PI533764,758.416495632521,776,49,869,820,1374248
PI533764,804.740864168248,840,352,938,586,2080938
PI533764,834.5975388357731,861,4,1038,1034,1930749
PI656085,1337.2756318712457,1386,152,1661,1509,2323523
PI656085,810.0933854068636,846,8,1021,1013,1709137
PI656085,1255.7081772238016,1298.5,703,1600,897,2723033
PI597982,684.7074874278264,728,2,780,778,1025375
PI597982,756.1859541144773,749,75,968,893,2120149
PI597982,618.3294270598287,660,5,736,731,985024
PI597982,666.82277312419,695,5,752,747,1011838
PI576359,1285.002709303689,1378,2,1640,1638,2884778
PI576359,820.0833802598793,836,2,935,933,1913895
PI576359,1332.6381520978787,1367,2,1654,1652,3045454
PI533990,1726.1996732026143,1738,1316,1850,534,5245353
PI533990,1387.6145634983723,1410,3,1608,1605,3232919
PI533990,1468.616802572508,1512,8,1703,1695,3100512
PI533746,838.5674552195937,836,2,1262,1260,1523097
PI533746,816.9891871566019,912,2,1110,1108,963736
PI533800,923.2486928104576,939,348,1193,845,2821934
PI533800,1606.450406681191,1644,536,1915,1379,4092058
PI533800,1150.336643806127,1165.5,433,1350,917,3093885
PI533943,924.1659387790113,925,382,1171,789,2404164
PI533943,661.1179408261984,752,2,912,910,493539
PI533943,408.8636357156096,468.5,2,577,575,199894
PI534075,124.50291079812207,118,14,163,149,8283
PI534075,351.39339434577744,403,4,474,470,220960
SC1058,1205.157116620753,1200,614,1356,742,2737718
SC1058,1201.9257896881122,1218,199,1384,1185,3623377
SC1058,1209.3058780077415,1245,2,1423,1421,1897611
PI534106,994.337908496732,994,827,1130,303,3040235
PI534106,1015.7514959666755,1016,11,1232,1221,3055316
PI534106,1021.9833684437963,1060,407,1265,858,2794828
PI656052,1137.9022875816993,1171,242,1281,1039,3443522
PI656052,929.2346405228758,905,627,1181,554,2819236
PI656052,1295.7326797385622,1300,698,2165,1467,3925424
PI656077,991.3872549019607,1020,758,1207,449,3027765
PI656077,387.75730619510574,405,56,526,470,930286
PI656077,1171.0189542483658,1192,355,1344,989,3547873
PI534045,1256.673796791444,1335,920,1414,494,3605607
PI534045,935.8911764705882,937,556,1059,503,2852208
PI534045,1446.0947712418301,1443,1108,1615,507,4419478
PI533986,1341.585294117647,1353,1066,1498,432,4099883
PI533986,345.1722012926832,393.5,2,1089,1087,191005
PI533986,366.93051378446114,432,4,597,593,205437
PI533986,1723.3950980392156,1767,1064,1925,861,5228724
PI656012,2013.5115055586602,2032,850,2201,1351,6137263
PI656012,1793.4956620403377,1816,727,1970,1243,5339600
PI656012,1649.5500773993808,1654,698,2062,1364,4747186
PI656016,1638.1728758169934,1618,668,1911,1243,4997747
PI656016,1531.1726608187134,1602,427,1754,1327,4582375
PI656016,1226.5885620915033,1238,439,1354,915,3747369
SC0631,1065.5764705882352,1088,728,1561,833,3223714
SC0631,1381.7136081343851,1443,221,2307,2086,4177626
PI597957,1132.592156862745,1143,841,1286,445,3458088
PI597957,1440.582679738562,1458,422,2398,1976,4183284
PI597957,1351.0597874222055,1401,561,1608,1047,4059680
PI655994,912.4892840857274,958,589,1005,416,2449962
PI655972,1369.298366013072,1421,491,1523,1032,4176842
PI655972,880.0339555776912,868,3,1153,1150,2036055
PI655972,1271.8169934640523,1331,732,1854,1122,3830991
PI656044,1782.6696078431373,1807,1553,2753,1200,5446786
PI656044,2027.5607843137254,2047,1212,2130,918,6196252
PI656044,1852.2823073564723,1858,791,2070,1279,5648917
PI533978,1000.294343708674,1065,2,1122,1120,1939215
PI533978,971.5321978021977,1028,4,1095,1091,1710880
PI533978,1146.9973856209149,1166,852,1936,1084,3487680
PI533752,2098.143790849673,2087,1403,2320,917,6352169
PI533752,1527.0846405228758,1552,798,1598,800,4667380
PI533752,1930.317973856209,1952.5,1221,2182,961,5885336
PI534115,1618.350980392157,1652,1115,1922,807,4942970
PI534115,1376.8926667136034,1420,344,1494,1150,3606495
PI534115,1380.3496540485746,1421,337,1494,1157,3594792
PI534115,1265.5777781675406,1341,3,1427,1424,1895282
PI533878,2129.6481021053164,2245,53,2328,2275,4978499
PI533878,1569.582699611376,1613,74,1804,1730,3542233
PI533878,1675.4745098039216,1666,1103,1909,806,5119550
PI533878,1676.986274509804,1667.5,1152,1912,760,5122027
PI655975,1605.8647058823528,1634,1132,1902,770,4908944
PI655975,1607.4522875816992,1636,1142,1904,762,4914580
PI655975,1188.0042483660131,1194.5,758,1876,1118,3619726
PI655975,1190.1052287581701,1194.5,582,1892,1310,3617627
PI655975,1189.8317789591279,1196,517,1885,1368,3619311
PI655975,1405.4254901960785,1419.5,1130,1526,396,4295668
PI656056,1547.230065359477,1542,1278,1694,416,4718550
PI656056,1346.0556743909685,1360,433,1418,985,2813521
PI656056,1550.5613405645945,1579,770,1731,961,4207928
PI576331,1083.8495951118962,1120,3,1207,1204,1511297
PI576331,1123.8732633573875,1141,385,1327,942,2462588
PI576331,861.5998731618809,887.5,5,1072,1067,1063913
PI533928,1454.1479471454034,1499.5,2,1644,1642,2313215
PI533928,1046.3683006535948,1050,480,1175,695,3191653
PI597971,1291.9031721190859,1342,396,1843,1447,3901184
PI597971,1118.415693207613,1148,8,1261,1253,2457968
PI597971,1434.3991962523037,1456,2,1733,1731,3122340
PI534036,1178.3608641243495,1220,2,1367,1365,1598433
PI534036,1993.4179738562093,1968.5,861,2335,1474,6067185
PI534036,1549.390252227236,1615,4,1767,1763,1917237
PI533965,1200.937974334142,1252,15,1339,1324,2580595
PI533965,1231.809687782722,1321.5,2,1436,1434,1074791
PI533965,901.7598039215686,899,757,1034,277,2756631
PI533921,1122.1450082741849,1143,420,1654,1234,3359689
PI533921,1128.518239829692,1153,2,1312,1310,3111317
PI533921,1417.5651013864665,1430,630,1577,947,3470114
PI533853,873.819862506452,941.5,2,1077,1075,986797
PI533853,145.35777841561423,163,10,186,176,25692
PI533853,1049.6282163406213,1173,3,1407,1404,940461
PI595719,1531.036274509804,1546,1035,1720,685,4676285
PI595719,1569.6515465041653,1652,3,1848,1845,3864389
PI595719,1687.5264705882353,1675,1257,1895,638,5156131
PI533790,485.6684210526316,517,3,609,606,399574
PI533790,1107.3810457516338,1123,892,1293,401,3385160
PI533907,706.2040825973045,731,6,852,846,694666
PI533907,1519.3474765222513,1673,8,1752,1744,2054565
PI533907,2020.9316993464054,1989,1242,2231,989,6165463
PI533907,1049.6528641398659,1169,479,1495,1016,2373686
PI533907,1204.8504214670047,1243,478,1489,1011,2573239
PI533805,1034.0677142724703,1078,8,1257,1249,2209538
PI533805,1435.4707117221496,1483,595,1590,995,4087332
PI533805,1450.455178127589,1525,386,1678,1292,3235632
PI534066,771.2905377668309,803,3,849,846,997508
PI534066,755.5774509803921,769,399,893,494,2290881
PI534066,111.18830845771144,118,17,121,104,7159
SC0871,962.9187523895351,1029,3,1234,1231,1459865
SC0871,870.6382464311287,949,3,1231,1228,637074
SC0871,1170.7977024834133,1252.5,3,1468,1465,2526353
PI533985,1065.9021237597276,1135,2,1200,1198,1271132
PI533985,1107.9271745544856,1152,2,1227,1225,1950357
PI533985,1324.1760542312163,1328,596,1542,946,3808304
PI533985,1114.2271241830065,1138.5,260,1245,985,3399789
PI534154,1427.3764705882354,1442,649,1589,940,4348903
PI534154,863.5824823066533,831,11,1642,1631,2511477
PI534154,1513.331016042781,1506,660,1724,1064,3778127
SC0314,1167.2529411764706,1134,878,1744,866,3558042
SC0314,1415.7090890209533,1443,6,1892,1886,4155024
SC0314,829.1702499135674,868,381,951,570,2070814
PI595699,1099.9734446920409,1115.5,388,1362,974,2842847
PI595699,1416.7650326797386,1449,892,2260,1368,4322519
PI595699,1485.5738562091503,1492.5,1185,1742,557,4542280
PI576367,949.1784313725489,955,730,1115,385,2897799
PI576367,1467.1169700219862,1444,236,1716,1480,4437970
PI576367,1061.9729350092616,1099,198,1233,1035,3176399
PI534006,1586.1016339869282,1640.5,1240,2765,1525,4838883
PI534006,1370.450977138129,1419,588,1539,951,3995839
PI534006,1199.3549019607844,1225,704,2084,1380,3620930
PI533988,1492.7186274509804,1469,1057,2741,1684,4261465
PI533988,1481.102614379085,1459,1054,2738,1684,4258177
PI533988,1191.9699346405228,1184,670,1526,856,3582037
PI533988,1225.530392156863,1226,615,1532,917,3661551
PI533988,1462.0192810457515,1496,614,1759,1145,4449651
PI533756,1230.689385426475,1252,3,1491,1488,3638006
PI533756,441.61403255975443,442,21,563,542,995038
PI533756,1709.4225490196077,1748,1057,1882,825,5220139
SC0458,867.8186274509803,869,707,1048,341,2631925
SC0458,830.7124183006537,825,648,1015,367,2510288
SC0458,1007.6176470588234,1040,277,1246,969,3026307
SC0458,1029.837334091771,1045,9,1149,1140,2760652
PI533936,1040.0707819163702,1045,16,1371,1355,2949879
PI533936,1171.0814685606601,1210,412,1561,1149,3242858
PI533936,993.6178610625584,1010,200,1147,947,2769849
PI533936,789.5699049316697,825,499,908,409,2181697
PI576344,1609.993393090855,1685,2,2632,2630,3895662
PI576344,1859.5420721100822,1913,828,2044,1216,5241444
PI576344,1734.2977124183008,1778,1441,2692,1251,5286911
PI533915,1199.4235294117648,1202,1067,1318,251,3664658
PI533915,1527.149019607843,1617,349,1779,1430,4659977
PI533915,1344.5267973856207,1306.5,1119,1546,427,4110507
PI533915,1163.6785629903566,1221,255,1358,1103,3457901
PI533915,1035.1401960784315,1031,677,1760,1083,2969514
PI533915,1350.1637254901962,1350.5,1075,1483,408,4124488
PI533816,1109.002614379085,1125,547,1306,759,3381193
PI533816,855.106862745098,894,350,1097,747,2601243
PI533816,1000.675816993464,1097,329,1350,1021,3029898
PI533816,1072.9872549019608,1058,738,1314,576,3197188
PI533816,1121.6442067736186,1109,806,1286,480,3193755
PI533816,1093.837254901961,1104,878,1231,353,3108318
PI533774,1632.6532679738561,1623,1029,1812,783,4988533
PI533774,1810.8594771241828,1825,1062,1919,857,5529192
PI533774,1451.5444444444445,1492,630,1649,1019,4438420
PI533774,1305.9964052287582,1310,781,1402,621,3990182
PI533774,1782.4290849673203,1787,634,1926,1292,5440885
PI533774,1513.6509803921567,1525.5,763,1637,874,4624514
PI533991,1106.0238562091504,1090,716,1278,562,3381708
PI533991,1245.924183006536,1258,786,1346,560,3810065
PI533991,1467.6558823529413,1486.5,1177,1571,394,4476241
PI533991,979.4124183006536,984,759,1100,341,2992435
PI533991,1081.6385620915032,1073,813,1234,421,3304077
PI533991,1358.1820569616189,1364.5,1093,1450,357,4133949
PI533984,1521.325238813474,1537,907,1658,751,4414266
PI533984,1275.8026143790848,1289,1076,1375,299,3900425
PI533984,1422.8026143790848,1439,849,1523,674,4342488
PI533984,1275.3496732026142,1269,952,1362,410,3891745
PI533984,1680.8781045751634,1678,1122,1764,642,5135953
PI533984,1160.8738562091503,1172,771,1239,468,3543768
PI656106,1560.0588235294117,1561,1014,1704,690,4768820
PI656106,1340.8522875816993,1351,1143,1411,268,4095713
PI656106,1367.8967320261438,1402,1000,1491,491,4185215
PI656106,1812.7921568627448,1812,1276,1967,691,5536756
PI656106,1302.2509803921569,1344,883,1410,527,3978910
PI656106,1347.3091503267974,1349,1085,1487,402,4118351
PI533897,1179.881045751634,1177,713,1356,643,3600311
PI533897,1385.8081699346405,1382,1003,1555,552,4234841
PI533897,1571.736708134504,1591,901,1743,842,4785427
PI656001,1632.6565862242333,1646.5,1057,1783,726,4758670
PI656001,1474.3980392156864,1486,786,1639,853,4464595
PI656001,1541.840522875817,1552,1220,1642,422,4702478
PI656001,1393.0575163398694,1402,1093,1501,408,4254826
PI656001,1335.5856209150327,1346,895,1430,535,4079389
PI656001,1321.4016339869281,1348,924,1389,465,4037804
BTx399,1734.9712418300653,1770,1161,1864,703,5305385
BTx399,1508.8960784313726,1543,938,1626,688,4613233
BTx399,1631.6156862745097,1649,867,1765,898,4984129
BTx399,1698.9977124183006,1691,869,1913,1044,5189428
BTx399,1474.3441176470587,1467,1087,1640,553,4506841
BTx399,1714.25522875817,1759,716,1825,1109,5237864
PI533930,1570.8019607843137,1572,1346,1675,329,4801517
PI533930,1079.3368723882995,1095,405,2322,1917,3129653
PI533930,1788.8029411764705,1821,622,1898,1276,5466534
PI533930,1514.5624183006535,1541,820,1616,796,4628537
PI533930,1917.1800653594769,1936,952,2073,1121,5838242
PI533930,1884.5781045751633,1894,676,2039,1363,5752694
PI534001,1532.234640522876,1550,1260,1647,387,4683324
PI534001,1642.7771241830064,1640,1297,1785,488,5012936
PI534001,1720.9915032679737,1785,1035,2013,978,5257311
PI534001,1621.0627450980392,1616,738,1816,1078,4952959
PI534001,1533.7725490196078,1557,762,1649,887,4686807
PI534001,1536.5261437908498,1568,821,1669,848,4692195
PI533803,1002.3954248366013,1012,760,1121,361,3060465
PI533803,591.1656862745099,612,391,713,322,1804028
PI533803,941.0097820289301,946,363,1110,747,2586599
PI533803,965.8934640522875,1007,730,1091,361,2940676
PI533803,941.3411764705882,994,287,1149,862,2859031
PI533803,807.6138597201082,803,400,960,560,2453298
PI533983,1667.5326797385621,1700,1197,1833,636,5093900
PI533983,1509.4470588235295,1521,814,1608,794,4613539
PI533983,1382.5915032679738,1407,1108,1484,376,4225306
PI533983,1557.021568627451,1565,1030,1718,688,4758557
PI533983,1322.2098039215687,1332,593,2079,1486,4042174
PI533983,1399.512091503268,1416,554,1503,949,4274536
PI597976,968.1761437908497,986,418,1101,683,2954020
PI597976,1242.6019607843136,1244,1058,1329,271,3799946
PI597976,708.8401960784314,703,442,861,419,2167905
PI576392,1425.4950980392157,1441,946,1556,610,4346038
PI576392,1436.069934640523,1463.5,761,1622,861,4382928
PI576392,1983.2238562091502,1995.5,1329,2117,788,6008034
PI576392,1752.5598039215688,1776,1255,2061,806,5204586
PI576392,1711.0764705882352,1730.5,810,1918,1108,5213048
PI576392,1673.228431372549,1701,1093,1940,847,5075563
PI656060,1145.9683006535947,1147,798,1264,466,3428691
PI656060,1091.7254901960785,1125,784,1224,440,3310759
PI656060,1122.9183006535948,1135,713,1297,584,3434918
PI656060,1051.493285799168,1067,739,1215,476,2977275
PI656060,864.2343540800969,888,269,1059,790,2606364
PI656060,1258.438654998116,1301,360,1404,1044,3756776
PI533808,1076.7303921568628,1064,855,1328,473,3282685
PI533808,1525.2450980392157,1546,1117,1678,561,4663207
PI533808,1455.0274509803921,1533,1175,1609,434,4420319
PI533808,1131.6398692810458,1147,840,1315,475,3437371
PI533808,1601.7748687032113,1678,802,1796,994,4880759
PI533808,1132.0204223978149,1163.5,70,1264,1194,2601480
PI534123,1426.8532679738562,1455,683,1529,846,4360323
PI534123,1683.8915032679738,1702,1262,1804,542,5126345
PI534123,1602.4436174192188,1615,641,1739,1098,4679489
PI534123,1332.966339869281,1337,1016,1408,392,4078574
PI534123,1478.3996732026144,1503,1163,1602,439,4521756
PI534123,1323.9055555555556,1355,1106,2097,991,4046117
PI534142,1005.3649650168438,1032,522,1247,725,2685056
PI534142,1063.4000152473889,1089,9,1183,1174,1920173
PI534142,1398.1029411764707,1420,1078,1567,489,4277378
PI534142,1437.8457516339868,1450,730,1532,802,4396654
PI534142,1323.4650326797387,1343,928,1423,495,4046194
PI534142,1095.9555555555555,1109,750,1228,478,3326299
PI534010,1130.7127450980392,1158,652,1398,746,3443447
PI534010,1543.7581845673592,1566,1221,1654,433,4297866
PI534010,1512.0370159008876,1507,1187,1627,440,4229820
PI534010,1301.2722222222224,1334,397,1433,1036,3974956
PI534010,1357.036928104575,1392,1069,1489,420,4145854
PI534010,1337.9954248366012,1370,696,1472,776,4080286
PI533905,1594.7712418300653,1597,1252,1804,552,4788424
PI533905,1564.8820261437909,1591,1155,1738,583,4778359
PI533905,1657.8362745098038,1704.5,982,1915,933,5061437
PI533905,905.0375816993464,711,234,1969,1735,2103883
PI533905,1477.0485090316215,1512,619,1703,1084,3897852
PI533905,1652.409477124183,1665,782,1872,1090,5024304
PI533886,823.3326797385621,842,693,901,208,2512806
PI533886,850.8281045751635,864,694,1009,315,2600981
PI533886,818.3633986928105,835,627,938,311,2503768
PI533886,833.7964052287582,837.5,598,941,343,2535365
PI533886,752.5271241830065,767,399,897,498,2265126
PI533886,1026.0346405228759,1095,771,1215,444,3134781
PI534158,1403.1486928104575,1407,661,1508,847,4284358
PI534158,1294.318954248366,1288.5,603,2193,1590,3940607
PI534158,1349.6140522875817,1387,1118,1458,340,4124395
PI656094,1305.432679738562,1293,646,1458,812,3940854
PI656094,1183.4258169934642,1170,745,1794,1049,3595523
PI656094,1091.7,1125.5,367,1376,1009,3213728
PI595711,1003.7973856209151,981.5,684,1129,445,3068643
PI595711,1100.2901960784316,1125,727,1242,515,3356481
PI595711,1032.7287581699347,1050,681,1146,465,3153628
RTx430,1204.8125676678796,1176,994,1418,424,3530428
RTx430,1249.0294637697907,1258,63,1470,1407,3780732
RTx430,1664.9035947712418,1694,1107,1812,705,5088906
RTx430,1662.799019607843,1691,1000,1812,812,5081906
PI533831,1829.3470588235296,1856,1028,1964,936,5580636
PI533831,1561.6212418300654,1568,1390,1677,287,4773509
PI533831,1814.1869281045751,1836,1340,2009,669,5534661
PI533942,1368.3968325791855,1344,1102,1548,446,3945145
PI533942,1219.2580256428373,1207,464,1459,995,3672389
PI533942,1195.8728758169934,1198,428,1406,978,3653486
PI576421,1825.213071895425,1819,442,2172,1730,5477866
PI576421,1910.2761437908498,1936,1171,2026,855,5824889
PI576421,1684.757843137255,1677,1455,1913,458,5150060
PI576339,1585.6480392156864,1577,631,1806,1175,4801254
PI576339,1676.3967320261438,1700,800,1874,1074,5081930
PI576339,1464.1192810457514,1474,675,1628,953,4472147
PI656020,1465.4041366513861,1500,551,1666,1115,4472562
PI656020,1046.7124183006536,1056,695,1319,624,3197405
PI656020,1020.4556697460376,1061,469,1253,784,2478314
PI533994,1195.2888888888888,1206,1047,1284,237,3649166
PI533994,1260.2872549019608,1268,921,1336,415,3850316
PI533994,1205.1084967320262,1211,501,1293,792,3683405
PI153846,1005.7042483660132,1017,797,1140,343,3039052
PI153846,1197.8238562091503,1187,728,1345,617,3651111
PI576387,1479.7779504860227,1498,452,1604,1152,4497047
PI576387,1061.8522475482168,1054,393,1314,921,3220242
PI576387,1150.1937908496734,1156,616,1332,716,3483788
PI576366,1437.7810457516339,1444,1074,1620,546,4393240
PI576366,1170.3369281045752,1152,586,1966,1380,3556842
PI576366,1364.285294117647,1398,751,1497,746,4163840
PI533979,1360.7843137254904,1367,453,1474,1021,4154585
PI533979,1081.601490170397,1102,361,1757,1396,3225606
PI533979,1278.5872549019607,1297,350,1386,1036,3901210
PI153844,1087.2718954248367,1092,606,1270,664,3318239
PI153844,806.0826797385621,871,397,1000,603,2450022
PI153844,1167.924836601307,1169,901,1300,399,3566160
PI534128,1851.24477124183,1903,1006,2072,1066,5649765
PI534128,1490.2418300653594,1489,1255,1639,384,4559085
PI534128,1471.4673202614379,1476,706,1657,951,4496027
PI534017,1050.5882352941176,1076,838,1236,398,3210878
PI534017,1456.9521092409432,1466,730,1581,851,4443502
PI534017,1442.958245238036,1510,2,1625,1623,3528052
PI533794,1376.9098938069005,1395,749,1418,669,4203729
PI533794,1253.4892156862745,1270.5,825,1351,526,3828392
PI533794,1627.4738562091504,1694,50,1780,1730,4968816
PI533964,1182.5977124183005,1188,604,1327,723,3611450
PI533964,1304.3683100503247,1330,152,1438,1286,3828864
PI533964,1388.1318125387957,1416,748,1587,839,4220938
PI534039,1487.1643790849673,1502,1208,1580,372,4529408
PI534039,1440.8300977023111,1440,430,1608,1178,3926546
PI534039,1299.2601307189543,1318,720,1422,702,3969516
PI656034,1199.8238562091503,1184,872,1344,472,3667013
PI656034,1467.1771241830065,1484,916,1590,674,4479907
PI656034,1452.7736404843536,1450,686,1631,945,4436820
SC0191,916.240522875817,936,725,1016,291,2801284
SC0191,932.6784507096725,949.5,386,1035,649,2840523
SC0191,1410.8009803921568,1412,666,1550,884,4298972
SC0297,777.2568881685575,851,3,925,922,1276533
SC0297,351.73846153846154,366,19,396,377,142078
SC0297,881.77418300653585,850,353,1116,763,2670344
PI533904,997.6234015345268,1005.5,301,2206,1905,2835243
PI533904,1398.1454248366013,1390,670,1573,903,4268182
PI533904,929.3420177311849,940,125,1363,1238,2734946
PI595743,901.2979957404248,940,2,1078,1076,1301004
PI595743,652.9945900950357,757.5,2,977,975,1261791
PI595743,1008.1975525743292,1072,2,1124,1122,1127057
PI534054,1321.045751633987,1335,813,1479,666,4034815
PI534054,1234.2843137254902,1250.5,490,1320,830,3769085
PI534054,1159.8323529411764,1163,856,1306,450,3543247
PI561073,1548.678596376337,1579,707,1755,1048,4727242
PI561073,1560.613725490196,1553,822,1716,894,4762000
PI561073,1676.738980700335,1667,695,2868,2173,5057785
PI597958,1189.6032679738562,1197,789,1305,516,3612786
PI597958,1122.723202614379,1136,833,1320,487,3424233
PI597958,939.7604575163399,925,785,1086,301,2873275
PI656100,1325.2452842912467,1336,554,1451,897,4044358
PI656100,1293.6339252924483,1311,445,1424,979,3949580
PI656100,1298.953594771242,1319,427,1425,998,3967511
PI656100,1660.3491244539935,1695,955,1817,862,5045061
SC0618,1150.7937908496733,1154,632,1303,671,3511839
SC0618,1169.8650326797385,1181,676,1303,627,3573628
SC0618,995.4434640522875,1016.5,405,1101,696,3042577
PI656036,1502.8767973856209,1494,1113,1617,504,4592648
PI656036,1557.6343137254903,1561,1210,1683,473,4758989
PI656036,1277.7375816993463,1288,745,1413,668,3900854
PI533765,818.2820261437909,820,597,975,378,2501675
PI533765,1112.1745098039216,1115,961,1209,248,3395686
PI533765,1124.0238562091504,1112,923,1257,334,3428362
PI48770,1349.5418300653596,1354,1188,1459,271,4123874
PI48770,1521.680065359477,1542,853,1682,829,4625407
PI48770,1748.8362745098038,1789,640,1931,1291,5341102
SC0263,937.0023273880606,964,365,1107,742,2841431
SC0263,712.3385620915033,708,425,863,438,2177282
SC0263,1080.8771241830063,1051,503,1309,806,3290092
PI597966,1020.1774509803922,1018,474,1164,690,3114568
PI597966,1406.8944444444446,1401,1098,1497,399,4296523
PI597966,1598.4790849673204,1601,737,1732,995,4884325
PI533987,1034.113725490196,1042.5,783,1238,455,3152190
PI533987,1352.7876564142416,1392,104,1468,1364,4130820
PI533987,1392.8019607843137,1416,1037,1657,620,4251243
PI656118,1293.7888888888888,1295,1014,1414,400,3947186
PI656118,1128.0019607843137,1136,565,1216,651,3446924
PI656118,1283.6081699346405,1311,618,1346,728,3921645
PI534136,1276.8385620915033,1294,934,1486,552,3900955
PI534136,1410.8169934640523,1430,929,1552,623,4308837
PI534136,1505.5124183006537,1573,683,1695,1012,4597829
PI576409,1045.562091503268,1061,878,1156,278,3187711
PI576409,1224.4088235294118,1225,975,1359,384,3740022
PI576409,1528.7901960784313,1544,834,1622,788,4665231
PI595724,1339.924183006536,1347,1053,1480,427,4096677
PI595724,1406.2487453353904,1436.5,453,1612,1159,4195796
PI595724,1491.3049019607843,1560,404,1853,1449,4559900
PI576402,1547.0113109222784,1601,593,1746,1153,4381656
PI576402,1311.3825930634207,1333.5,517,2456,1939,3956330
PI576402,1489.654966164593,1544,381,1683,1302,4543213
PI534159,1749.0302671136296,1768,897,2022,1125,5166952
PI534159,1577.1480392156864,1570,1018,1716,698,4822158
PI534159,1457.9852671343767,1505,610,1693,1083,4437659
PI534076,1028.1545751633987,1037,814,1146,332,3141597
PI534076,1171.8375816993464,1225,775,1335,560,3578577
PI534076,1177.931045751634,1197,875,1888,1013,3594629
PI534094,1113.3598039215685,1143,784,1287,503,3402743
PI534094,968.721568627451,996,680,1167,487,2959234
PI534094,1059.0950980392156,1080,757,1248,491,3233494
PI534056,1149.94477124183,1154,879,1226,347,3516232
PI534056,948.7349673202614,969,656,1064,408,2898150
PI534056,1061.7803921568627,1081,761,1168,407,3246598
PI534106,1138.6859477124183,1125,510,1302,792,3478027
PI534106,1024.6266889678584,1042,246,1147,901,3047507
PI534106,1125.8411764705884,1104,720,1341,621,3437540
PI533781,873.95,892,519,1087,568,2656319
PI533781,1182.7666666666667,1178,744,1344,600,3551192
PI533781,1065.9604575163398,1073,798,1195,397,3258973
PI533935,916.8254901960784,949,686,1100,414,2801028
PI533935,1590.5918300653593,1597,955,1840,885,4854946
PI533935,1595.181045751634,1601,1225,1828,603,4867450
PI533935,1150.8143790849672,1137,841,1363,522,3514322
PI613536,1296.775953899411,1318,507,1533,1026,3953457
PI613536,1207.0738562091503,1207.5,471,1332,861,3686669
PI613536,1401.71181302334,1445,757,1598,841,3981705
PI533953,1256.9944444444445,1252,720,1426,706,3836313
PI533953,987.7751633986928,1011,770,1090,320,3021011
PI533953,1035.3807189542483,1067,809,1190,381,3164825
PI534125,1625.1944444444443,1689,776,1847,1071,4971878
PI534125,1441.6245098039217,1466,1006,1629,623,4393394
PI534125,1235.028020868791,1251,566,1442,876,3716886
SC1133,1305.7003267973855,1302,971,1458,487,3992352
SC1133,1220.270588235294,1225,650,1386,736,3719859
SC1133,1128.092156862745,1155,961,1255,294,3448489
SC0550,830.3078431372548,838,678,902,224,2536617
SC0550,681.1554114342366,708,346,1366,1020,1994143
SC0550,844.6101276147538,805,469,1167,698,2532608
PI659695,1057.075163398693,1047.5,854,1219,365,3232396
PI659695,1084.4732026143793,1071,750,1250,500,3306238
PI659695,956.356862745098,954,781,1125,344,2925783
PI533929,1401.486274509804,1415,829,1503,674,4282160
PI533929,1105.3935449490864,1087,536,1288,752,3355936
PI533929,1255.842156862745,1243,554,1381,827,3833926
PI533756,1438.6952232366425,1418,655,1600,945,4388331
PI533756,1195.5470588235294,1181,887,1297,410,3652414
PI533756,1221.0486040347898,1232,637,1428,791,3714907
PI656014,1008.3820261437909,1012,561,1223,662,3052035
PI656014,1319.6898692810457,1343,582,1439,857,4018438
PI656014,1358.410529020839,1423,195,1582,1387,3963145
PI576398,1287.0515032679739,1378,214,1504,1290,3138416
PI576398,1793.8392156862747,1846,1019,2129,1110,5070359
PI576398,1847.075095726364,1871,55,2423,2368,5620551
PI533869,568.7364491597901,681,3,785,782,707087
PI533869,1294.0575163398694,1314,1056,1432,376,3953735
PI533869,1364.8114379084968,1370.5,1141,1584,443,4152358
SC0581,663.6681866815528,647,36,1628,1592,1406558
SC0581,1288.6320261437909,1351,58,1823,1765,3823360
SC0581,868.6197748025763,917,373,1210,837,2346040
PI656059,1449.8029411764705,1435,425,1783,1358,4335828
PI656059,1094.4091503267973,1163,411,1745,1334,3093127
PI533747,1316.296355585831,1413.5,9,1720,1711,2153510
PI533747,835.9361215408148,855,198,1237,1039,2198770
PI533747,994.0856209150327,1096,472,1487,1015,2739673
PI533810,927.3640522875817,999.5,185,1258,1073,2793951
PI533810,1194.998355523015,1324,72,1780,1708,3389180
PI533810,1212.31568627451,1198,314,1502,1188,3684029
PI656074,1063.7673956762192,1033,627,1488,861,3011364
PI656074,814.8889181146712,775,161,1456,1295,2121906
PI656085,1589.1281045751634,1614,1112,1746,634,4827294
PI656085,602.0015992212489,611,344,746,402,1443086
PI656085,1212.9428104575163,1239.5,397,1393,996,3671845
PI576361,936.8627450980392,854,483,1366,883,2435266
SC0521,732.7966869649854,753,238,1152,914,1916246
SC0521,847.6967545780337,921,444,1008,564,2171603
PI533874,1144.0696078431372,1169,861,1321,460,3486307
PI533874,780.8022202007951,800.5,606,863,257,2162328
PI533874,487.3401960784314,505.5,213,701,488,1381307
SC0138,1221.2062091503267,1165,676,2167,1491,3285727
SC0138,927.3111111111111,904,635,1156,521,2817975
SC0138,909.2903714331262,968,212,1365,1153,2342111
PI534104,1198.5189542483658,1113,835,1659,824,3604738
PI534104,841.3982517144789,794,342,2007,1665,2123190
PI534104,1134.1663765880885,1147,356,1234,878,3446443
SC0685,922.0467320261438,943,285,1303,1018,2475754
SC0685,915.406844838392,909,215,1247,1032,1758137
SC0685,749.447385620915,780,312,906,594,2273678
PI595700,1117.2673202614378,1149,668,1308,640,2943593
PI595700,1153.3502849415627,1193,508,1438,930,3490676
PI595700,1458.7623788085225,1507,610,1808,1198,4250117
PI534067,923.8245098039215,948,542,993,451,2784311
PI534067,1345.1682939842603,1336,771,1697,926,3720113
PI534067,1395.0741712959912,1371,157,1939,1782,3768711
PI533749,1557.5754901960786,1594,1165,1677,512,4754506
PI533749,882.2956394498099,881,599,1050,451,2457603
PI533749,857.693599376578,852,200,1500,1300,2271659
PI533947,1075.4299061340319,1151,280,1647,1367,2990695
PI533947,1400.6432035466062,1348,665,2002,1337,4002841
PI533947,1017.4070181271939,1059,290,1741,1451,2963668
PI533844,799.3029362988976,778,536,990,454,2213813
PI533844,582.2112403100775,575,286,1085,799,1543748
PI533844,909.345751633987,921,236,1133,897,2542660
SC0893,895.3898692810458,924,510,1187,677,2729633
SC0893,1044.2029411764706,1032,828,1207,379,3188863
SC0893,955.595751633987,947,143,1098,955,2902551
PI561071,892.9333333333334,890.5,295,1322,1027,2344894
PI561071,1241.0343137254902,1318,651,1483,832,3673203
PI561071,1543.981045751634,1541,916,1743,827,4683555
PI576367,982.4529411764704,985,613,1254,641,2777473
PI576367,987.1039215686275,991,456,1139,683,2926241
PI576367,1308.4077884685473,1259.5,467,1777,1310,3555401
PI659696,1096.661111111111,1212.5,191,1432,1241,3322496
PI659696,1199.2996732026145,1174,911,1365,454,3625702
PI659696,727.5833333333333,726,343,996,653,2068026
PI534101,1612.0990196078433,1608.5,1042,1793,751,4708319
PI533809,1346.3382352941176,1369,990,1490,500,4043064
PI533809,1054.2813725490196,1088,423,1871,1448,3171019
PI533809,813.5016132620433,871,8,1165,1157,2349914
PI533750,1355.9084967320262,1379,676,1673,997,4133388
PI533750,1038.2917828201678,1026,364,1722,1358,3039779
PI533750,1774.1333333333334,1747,729,2235,1506,5092509
PI656050,897.720985060691,921,247,1142,895,2125876
PI656050,1201.2807189542484,1215,474,1469,995,3657552
PI656050,1251.978431372549,1251,1080,1398,318,3818866
PI576338,849.6104575163399,855,666,1010,344,2596957
PI576338,1152.8601307189542,1171,811,1310,499,3523440
PI576338,493.60718954248364,467,268,737,469,1125143
PI656121,934.0539215686274,998,84,1600,1516,2579927
PI656121,463.59901960784316,396,134,1016,882,1229833
PI656121,865.5637218183153,893,342,1271,929,2294472
PI533815,1222.3414685496653,1312,17,1595,1578,2253823
PI533815,685.2503267973856,690,230,1054,824,1902399
PI533815,1282.8467320261439,1334,856,1582,726,3814912
PI576333,980.328431372549,1048.5,225,1305,1080,2880835
PI576333,1196.3232026143792,1353,142,2142,2000,3547091
PI576333,1163.9327096742006,1217,338,1346,1008,3158186
PI597946,1037.3980392156864,1064,737,1189,452,3114018
PI597946,637.7284618228878,622,197,845,648,1891731
PI597946,1228.451837270341,1276,27,1494,1467,3383699
PI533911,695.3445685447175,740,188,879,691,1586097
PI533911,894.7024210791369,759.5,199,1548,1349,2656522
PI533911,1192.3272041190578,1220,780,1370,590,3173547
PI656019,1172.6490370835966,1295.5,3,1459,1456,2189817
PI656019,881.4973856209149,916,325,1075,750,2673165
SC0157,1491.4918140752734,1482,666,1769,1103,4397518
SC0157,465.4200545292806,516,3,578,575,355329
SC0157,876.9124388458723,908,50,2051,2001,2399261
PI533758,1552.0467320261437,1562,529,1929,1400,4580354
PI533758,613.225236140968,593.5,6,1271,1265,1488791
PI533758,1511.5794117647058,1508,541,2228,1687,3756108
PI576424,90.9029517951351,71,2,281,279,39980
PI576424,424.98053965295344,441,2,686,684,220466
PI533828,766.5572492065294,885,2,1045,1043,749103
PI533828,410.9054048163888,464,2,599,597,169204
PI533828,704.2645973482017,755.5,4,954,950,387954
PI534132,1088.976115211286,1141,2,1478,1476,2641204
PI534132,997.7601730944427,988,13,1433,1420,2605929
PI534132,1369.359477124183,1422,864,1540,676,4182014
PI656061,1052.0996732026142,1032,865,1923,1058,3188930
PI656061,934.1957516339869,925,779,1106,327,2762545
PI656061,991.1297385620915,1001,707,1194,487,2879178
PI533941,787.2562215694625,740,66,1353,1287,2250060
PI533941,1299.05,1379,639,1608,969,3798015
PI576415,1048.1575163398693,1045,873,1178,305,3179416
PI576415,981.9398692810457,988,711,1170,459,2951555
PI576415,1046.742156862745,1052,857,1207,350,3176664
SC0371,810.4901222937028,887.5,4,1514,1510,2246764
SC0371,688.6787581699347,724,133,938,805,2058188
SC0371,791.5735294117646,814,99,1107,1008,2379608
PI552861,1529.5892895834322,1592,2,2059,2057,3930477
PI552861,153.03984319061612,154,2,262,260,136266
PI552861,1220.5704526079207,1223,178,1310,1132,3520705
PI576431,796.7831164453823,790,114,1000,886,2059038
PI576431,775.4294117647058,812,168,958,790,2129726
PI576130,843.3716680875249,768,601,1075,474,2341376
PI576130,851.6959569022528,809,226,1168,942,2545409
PI576130,1308.17726199682,1355,2,1468,1466,3639820
PI597966,762.332252596751,777,27,969,942,2256755
PI597966,1493.1796677740863,1566,2,1793,1791,4481627
PI597966,735.8138567861083,826,49,854,805,1494646
PI595741,527.2685209441759,522,11,746,735,1245385
PI595741,944.8461920048057,936,21,1211,1190,2605259
PI595741,773.2343553459119,923.5,2,1044,1042,1793817
PI656094,731.6640522875816,721,176,1698,1522,2002975
PI656094,998.6980313092979,1047.5,63,1241,1178,2731976
PI656094,1261.9039215686275,1252,700,1543,843,3825812
PI656094,1268.5509803921568,1257,661,1546,885,3844971
PI153846,1114.5294888597641,1120,22,1328,1306,3328793
PI153846,1270.5692810457517,1353,573,1536,963,3734864
PI153846,948.1252897149237,992,21,1439,1418,2623178
PI153846,778.6303921568627,788,147,1768,1621,2279394
PI534146,1097.8658942364825,1090,549,1337,788,3123422
PI534146,1134.922038377571,1139,300,1347,1047,3314866
PI534053,848.0673385311636,854,20,1026,1006,2555933
PI534053,906.1724629875417,958,2,1063,1061,1908647
PI534053,855.3816778194061,878,5,995,990,1662154
PI534060,530.9060697772172,591,61,695,634,1593806
PI534060,761.1590361717854,790,7,1098,1091,2136387
PI534060,671.2958123662445,765,44,1073,1029,2001530
PI595743,1102.5925300901586,1135,20,1356,1336,3338425
PI595743,1162.3940087145968,1195,154,1310,1156,3359525
PI595743,556.0159041080846,606,39,833,794,1638507
PI659691,556.8636050950348,549,84,878,794,1437581
PI659691,842.3539355963653,892,6,1120,1114,2445127
PI659691,1038.8373995115169,1108,26,1365,1339,2590805
PI656118,1018.5150811954027,976,54,1194,1140,3036744
PI656118,550.5799384001119,525,9,919,910,1637027
PI533919,1003.4092956485348,1026,3,1419,1416,2726298
PI533919,1153.8591417340363,1180,22,1362,1340,3344000
PI533919,802.6334804373924,731,75,1180,1105,2006907
PI576371,621.6389242065516,653,38,1052,1014,1797619
PI576371,744.0155750366055,793,7,1338,1331,2034252
PI533840,611.1308739839307,613,32,769,737,1815594
PI533840,456.8216676213382,476,107,639,532,1314125
PI533840,652.8949349313621,634,6,824,818,1732644
SC0505,787.2188844098043,833,6,970,964,1634753
SC0505,1443.022819935223,1489,10,1747,1737,3975897
PI595726,824.0691979696146,853,417,1118,701,2397445
PI595726,1233.1545751633987,1272,501,1390,889,3765760
PI595726,945.753330956625,1055,142,1167,1025,2133348
PI595726,1081.7284062342887,1164.5,195,1373,1178,3290823
PI595726,843.8881808842117,856,506,1058,552,2528790
PI595726,1195.1679738562093,1243,251,1419,1168,3650246
PI533760,869.7310457516339,825,511,1348,837,2446213
PI533760,1100.4261437908497,1063,746,1491,745,3243105
PI533794,1310.8375816993464,1320.5,689,1614,925,3999439
PI533794,762.2693884630459,806,2,973,971,1511518
PI533794,1168.809997773539,1136,228,1536,1308,3539660
SC0777,1791.2619013977467,1798,812,2006,1194,5451223
SC0777,1000.8375719442005,996,711,1156,445,2825487
SC0777,1084.8549749496651,1114,12,1188,1176,3122776
PI533948,1323.4712418300653,1316,985,2074,1089,4036731
PI533948,1298.8183006535949,1322,135,1388,1253,3963291
PI533948,1301.138888888889,1313,834,1408,574,3966149
PI533948,1299.981045751634,1313,290,1409,1119,3967364
SC0156,942.6065359477125,976.5,682,1081,399,2877530
SC0156,1431.8540849673202,1507,600,1590,990,3332294
SC0156,772.1323621850293,776,422,1621,1199,2214434
PI576382,1145.0874241132553,1164.5,541,1287,746,3481219
PI576382,1779.8209150326797,1835,781,2005,1224,5377515
PI576382,1515.035294117647,1575,913,1732,819,4608092
PI534015,1634.0676470588237,1620,275,1821,1546,4990406
PI534015,1326.2016339869283,1331,729,1479,750,4051890
PI534015,1660.6091503267974,1681,800,1791,991,5073702
PI574455,1400.8784313725491,1402,1203,1473,270,4281865
PI574455,1943.2986928104574,1980,982,2061,1079,5935871
PI574455,1586.4797385620914,1591,999,1691,692,4828380
PI534020,1464.2486928104577,1478,946,2132,1186,4464886
PI534020,1490.601633986928,1517,597,2345,1748,4548311
PI534020,1837.7466294594,1888,685,2070,1385,5570569
PI656102,1332.6437908496732,1380,717,1454,737,4068376
PI656102,1057.3830065359477,1073,784,1142,358,3215184
PI656102,1067.8607843137254,1081,723,1164,441,3263120
PI534102,1506.0160130718955,1507,1239,1596,357,4595345
PI534102,1660.6022875816993,1668,1017,1826,809,5066609
PI534102,1538.2849673202613,1548,685,1660,975,4698665
RTx430,1374.5764705882352,1377,613,1516,903,4201680
RTx430,1060.3473963285621,1040,507,1167,660,3231830
RTx430,1365.145751633987,1347,616,1513,897,4170147
PI533880,883.876797385621,901,714,1024,310,2700330
PI533880,1113.436274509804,1124,795,1277,482,3400172
PI533880,1077.9035947712418,1096,801,1222,421,3240468
PI595701,1042.082026143791,1052.5,636,1250,614,3186662
PI595701,1348.8833333333332,1384.5,906,1496,590,4120446
PI595701,1310.10522875817,1321,907,1438,531,3968114
PI533863,1194.7081699346404,1227,871,1336,465,3630747
PI533863,1165.2607843137255,1172,728,1304,576,3531750
PI533863,1578.3777777777777,1591,1179,1768,589,4792999
SC1097,727.2833831404791,776,2,1011,1009,1173081
SC1097,489.5126296495872,529,2,713,711,348467
SC1097,1595.4565359477124,1624,1283,1788,505,4860262
SC0138,1180.4303921568628,1199,608,1310,702,3608387
SC0138,1203.185055304173,1246,418,1377,959,3330886
SC0138,1007.4192810457516,1049,503,1169,666,3075848
PI533808,1159.800722828707,1210,409,1325,916,3464636
PI533808,1161.9624394483105,1190,204,1262,1058,3424739
PI533808,1145.8108490351444,1176,8,1308,1300,2141514
PI534151,1272.7192810457518,1273,787,1410,623,3890802
PI534151,1041.1630718954248,1082,622,1183,561,3183166
PI534151,1254.010161653918,1264,560,1469,909,3812968
PI595714,1522.9748366013073,1526,1028,1659,631,4648524
PI595714,1525.8679738562091,1566,741,1678,937,4647430
PI595714,1365.6418300653595,1369,1182,1443,261,4171615
SC0003,1594.0647058823529,1609,817,1780,963,4859111
SC0003,2015.7462793314046,2321,1170,2541,1371,4946593
SC0003,1271.5624183006535,1261,877,1523,646,3866316
PI656046,1153.2865587750753,1164,379,1391,1012,3478522
PI656046,1791.04467210105,1858,18,2055,2037,4779077
PI656046,1502.1176470588234,1539,1161,1706,545,4587199
PI656004,1261.7003267973855,1246.5,1088,1382,294,3851944
PI656004,1311.262869653428,1296,317,1427,1110,3999809
PI656004,1377.9187627115298,1426,190,1513,1323,4021764
PI595735,1618.6176470588234,1643,718,1820,1102,4940506
PI595735,1880.1296626524625,1927,212,2044,1832,5734721
PI595735,1632.7486016410494,1621,603,1755,1152,4984838
PI641849,1197.9262574595057,1216,798,1270,472,3428054
PI641849,1029.973826500297,1064,718,1138,420,2907776
PI641849,990.274420677362,1010,682,1083,401,2790597
PI533911,1419.8303921568627,1423,927,1564,637,4329621
PI533911,1628.1264705882354,1635,881,1728,847,4972271
PI533911,2105.5359477124184,2166,815,2384,1569,6414514
PI656090,1145.7541295306,1157,732,1246,514,3273439
PI656090,1032.0245000275586,1052,2,1168,1166,2581941
PI656090,1517.990522875817,1507,939,1676,737,4635540
PI533966,1246.8483660130719,1239,917,1333,416,3811908
PI533966,1317.1245098039217,1303,975,1446,471,4024731
PI533966,1334.5013071895426,1331,598,1405,807,4077493
PI534165,1116.0627740751474,1124.5,535,1273,738,3381159
PI534165,1418.5468997248022,1456,567,1579,1012,4297940
PI534165,1568.894117647059,1571,953,1825,872,4778536
PI576421,1127.225163398693,1146,503,1345,842,3433421
PI576421,1341.0379084967321,1319,713,1581,868,4092649
PI576421,1849.7179738562093,1849,1180,2050,870,5650076
PI533821,1429.4843019717932,1482,3,1577,1574,3845877
PI533821,1469.936274509804,1487,861,1607,746,4489406
PI533821,1285.490522875817,1311,1006,1412,406,3925984
PI533980,1553.4281045751636,1555,1249,1655,406,4746909
PI533980,1652.6571895424836,1667,1208,1797,589,5044064
PI533980,1578.116339869281,1589,1046,1661,615,4821650
PI534084,876.3700699422785,874,346,1011,665,2381812
PI534084,1343.9839869281045,1345,935,1467,532,4091299
PI534084,1123.5549019607843,1129,944,1252,308,3416615
PI534157,1559.6529411764704,1577,990,1660,670,4765443
PI534157,1755.0101307189543,1742.5,1208,1955,747,5361605
PI534157,1582.5748366013072,1595,1135,1701,566,4834327
PI533925,1485.7274937805955,1512,537,1626,1089,4397582
PI533925,1376.9061522574834,1407,448,1565,1117,3940238
PI533925,1387.4467320261438,1395,1082,1485,403,4240330
PI576401,1638.3114379084968,1684,1261,1755,494,5007075
PI576401,1543.2424836601308,1552,744,1667,923,4713256
PI576401,1772.6816993464054,1809,1136,1896,760,5415171
SC1021,1331.4688725490196,1349,554,1407,853,3759599
SC1021,1498.2212418300653,1544,1275,1624,349,4581339
SC1021,1428.1104995111182,1487,4,1673,1669,2767988
PI533957,897.0003267973857,945,702,1053,351,2742318
PI533957,1294.1434640522875,1311,1110,1416,306,3949872
PI533957,1125.1617647058824,1130,894,1227,333,3434236
PI576351,168.7058823529412,183,35,203,168,40805
PI576351,908.618596397672,952,3,1088,1085,1726043
PI576351,1342.3079476379503,1380,13,1442,1429,3822021
PI534089,1088.3627450980393,1109,726,1266,540,3326675
PI534089,946.1643790849673,950,708,1020,312,2891975
PI534089,1082.313725490196,1100,885,1154,269,3307276
PI607931,114.17676767676767,119,13,136,123,7372
PI607931,1317.3565359477125,1343,408,1403,995,4020749
PI607931,1482.0999109319032,1511,376,1694,1318,4505852
PI656105,1116.702614379085,1116,640,1236,596,3403875
PI656105,1099.3483660130719,1112,826,1320,494,3354262
PI656105,1429.7669934640523,1447,607,1493,886,4368198
PI534142,787.0830802506299,829,8,887,879,1230328
PI534142,853.5085976015741,900,216,1027,811,2404795
PI534142,853.7698417609458,899,2,1071,1069,1721664
PI656019,1205.627732920229,1272,307,1389,1082,3535640
PI656019,1136.8321606202248,1144,6,1241,1235,3267192
PI656019,1200.512091503268,1241,743,2015,1272,3660494
PI597946,1147.8565359477125,1160,653,1350,697,3403651
PI597946,1479.0044278261762,1485,41,1644,1603,4470446
PI597946,1275.456862745098,1286,344,1516,1172,3822656
SC0542,1018.323202614379,1052,603,1145,542,3111411
SC0542,1396.5401960784316,1467,1052,1546,494,4262767
SC0542,1529.3186274509803,1527,1009,1714,705,4655173
PI533870,1510.556862745098,1555,887,1669,782,4586904
PI533870,1618.7359477124182,1619,743,1933,1190,4936994
PI533870,1276.8022875816994,1260,813,1455,642,3892975
PI659753,1430.765359477124,1466,653,1586,933,4369484
PI659753,1592.3918300653595,1612,614,1792,1178,4858884
PI659753,1658.4209150326797,1670,888,1918,1030,5063096
PI533933,1453.693137254902,1449,1208,1589,381,4433010
PI533933,1140.1369281045752,1109,433,1376,943,3481187
PI533933,1170.248661773834,1185,265,1306,1041,3568794
PI656071,1596.7196078431373,1615,965,1758,793,4860491
PI656071,1411.4,1480,875,1578,703,4314404
PI656071,1458.9039215686275,1486,568,1659,1091,4459345
PI534156,1312.9690582894918,1352,551,1489,938,3748791
PI534156,1366.3447712418301,1401,829,1516,687,4173990
PI534156,1311.0001782531194,1325,561,1509,948,3582221
PI576343,1139.5503920150852,1136,516,1393,877,3306334
PI576343,1076.2117647058822,1073,902,1297,395,3285654
PI576343,1090.8830065359477,1062,516,1367,851,3330701
PI656076,1497.6437908496732,1490,649,1605,956,4575776
PI656076,1262.2385620915034,1319,627,1416,789,3849461
PI656076,1623.4199346405228,1663.5,838,1828,990,4958151
PI533844,1199.4104575163399,1217,871,1381,510,3661351
PI533844,899.5835463470139,924,352,1011,659,2653056
PI533844,1068.677948377882,1068,73,1222,1149,3232706
PI576425,759.219022883603,774,3,865,862,2163076
PI576425,1117.331045751634,1123,866,1265,399,3416784
PI576425,1298.780196508428,1294,573,1473,900,3947795
SC1024,1925.918954248366,1959,789,2112,1323,5882387
SC1024,1841.333065271588,1846,663,2088,1425,5562809
PI534155,1464.8238562091503,1484,1027,1560,533,4473780
PI534155,1646.2055555555557,1674,707,1916,1209,4998766
PI534155,1656.9539215686273,1635,1068,1949,881,5064884
PI576394,1146.2176470588236,1147,886,1259,373,3502431
PI576394,871.4748366013073,889,480,973,493,2658731
PI576394,1032.4388888888889,1038,270,1232,962,3150702
PI656026,1207.6588235294116,1211,922,1265,343,3687100
PI656026,830.5212334493478,884,3,1038,1035,1430942
PI656026,1266.7748673668893,1321,2,1427,1425,2937272
PI534040,1303.9143790849673,1345.5,197,1521,1324,3964774
PI534040,1387.0944444444444,1385,579,1516,937,4234793
PI534040,1548.737571426737,1596,861,1715,854,4724930
PI656101,748.2875816993464,749,341,1396,1055,1896034
PI656101,935.3258169934641,965,598,1030,432,2849105
PI656101,882.9871183299191,887,757,952,195,2375997
PI534148,1196.180607714784,1203,253,1472,1219,3328739
PI534148,1282.9333333333334,1282,1034,1415,381,3922365
PI534148,1110.032026143791,1058,874,1323,449,3377728
SC0965,1148.0493464052288,1166,824,1269,445,3508553
SC0965,1310.9996732026143,1313,938,1498,560,3990949
SC0965,977.4748366013073,1013.5,413,1549,1136,2971245
PI576334,1329.8784313725491,1299,813,1748,935,4033471
PI576334,1573.5063571616988,1653,692,1760,1068,4471975
PI576334,1584.6568627450981,1609.5,662,1736,1074,4837015
PI533802,1222.4370597990437,1230,1030,1304,274,3499615
PI533802,1173.368954248366,1197,791,1290,499,3582089
PI533802,1258.2303921568628,1274,942,1345,403,3841525
PI656017,1127.2039215686275,1127,683,1269,586,3442651
PI656017,1421.157843137255,1443,1023,1576,553,4345656
PI656017,1421.9437908496732,1430,1026,1613,587,4331809
PI629034,948.3199346405229,972,655,1061,406,2861654
PI629034,1156.6039215686274,1157,603,1320,717,3524789
PI629034,1331.0990196078433,1318,844,1483,639,4058398
PI576386,923.0470116789885,945,375,1035,660,2814473
PI576386,810.5010763000853,827,268,886,618,2420013
PI576386,978.1254901960784,1012,711,1084,373,2991544
PI576412,1051.8764705882354,1049,906,1138,232,3200453
PI576412,1194.5556695417754,1227,70,1275,1205,3468559
PI576412,1128.8647110668894,1166,5,1228,1223,2944023
PI48770,1370.2423695833277,1372,89,1796,1707,3892317
PI48770,1442.3137254901962,1427,1290,1600,310,4401040
PI48770,1680.3395424836601,1696,692,1913,1221,5120940
PI534073,1533.4830065359477,1533,1282,1698,416,4683295
PI534073,1205.8424836601307,1230,699,1340,641,3677267
PI534073,1109.2918300653596,1126,767,1199,432,3386417
SC0870,1429.2823529411764,1452,1106,1596,490,4364657
SC0870,1226.5261437908498,1234,493,1521,1028,3713625
SC0870,1244.5952842392455,1266,212,1430,1218,3412704
PI656072,1998.8907922264611,2078,14,2215,2201,5814570
PI656072,1979.3386607369198,1998,821,2236,1415,5891112
PI656072,1768.1192810457514,1766,684,1909,1225,5396836
PI533905,1283.1022875816993,1300,601,1422,821,3923881
PI533905,1072.5111111111112,1064,365,1273,908,3239557
PI533905,1067.1434640522875,1062,643,1179,536,3263338
PI656034,1628.9996732026143,1654,987,1785,798,4976745
PI656034,1647.6016339869282,1663,845,1789,944,5029304
PI656034,1624.174836601307,1652,1143,1782,639,4956229
PI533827,1042.847385620915,1062,505,1154,649,3180188
PI533827,1081.7519607843137,1062,890,1259,369,3307616
PI533827,1046.3924836601307,1047,867,1115,248,3194286
SC0550,778.288392259791,796,332,842,510,2375440
SC0550,1100.3195781342838,1093,600,1163,563,3105246
SC0550,994.8556743909685,996,665,1071,406,2774969
PI576374,1646.786928104575,1666,1202,1767,565,5034481
PI576374,1425.0218954248367,1444,1012,1489,477,4360293
PI576374,1610.4754901960785,1610,1045,1739,694,4924601
PI656063,1377.3490196078433,1425,524,1575,1051,4046402
PI656063,894.5484725913941,909,26,1227,1201,2319944
PI656063,1209.4617647058824,1285,593,1507,914,2728414
PI597975,898.9264705882352,887,708,1076,368,2710605
PI597975,433.9917785417372,462,2,487,485,781611
PI597975,1200.7347218910727,1158,497,1488,991,2830114
PI533991,1119.5310457516339,1143,705,1240,535,3413544
PI533991,1111.807895911988,1133,512,1254,742,3267623
PI533991,1221.5937161808342,1260,548,1325,777,3523810
PI533952,995.6456070333738,936,408,2992,2584,2800302
PI533952,983.3885620915032,945.5,224,1439,1215,2807292
PI656032,952.2932573029212,970.5,635,1157,522,2584278
PI656032,1140.3262037929926,1160,35,1236,1201,3461024
PI656032,1040.1605380083067,1043,433,1127,694,3171728
PI656053,1231.9720933021526,1269,707,1618,911,2994115
PI656053,1417.697656756774,1472,369,1652,1283,4319458
PI656053,862.7491286509526,885,8,1101,1093,2277927
SC1193,971.9293929700336,1006,13,1203,1190,2326848
SC1193,923.1701226698863,949,307,1070,763,2463202
SC1193,1112.8983660130718,1143,574,1330,756,3246633
PI595700,1123.5184543492774,1142,482,1329,847,2906466
PI595700,624.906933902376,755.5,2,1194,1192,1733057
PI595700,969.4720905277534,1038,510,1309,799,2650660
PI576356,855.9002829319647,839,57,1591,1534,1908426
PI576356,739.4516088486677,796.5,221,1198,977,2023361
PI576356,708.3330846962998,741,34,983,949,1581423
PI656061,1055.627450980392,1098,348,1190,842,3185742
PI656061,569.0854012301728,598,3,771,768,715773
PI656057,1630.362452443664,1687.5,569,1732,1163,4721561
PI656057,977.4477280408748,966,11,1235,1224,2871610
PI656057,1280.5098039215686,1260.5,304,1674,1370,3865611
PI595717,772.5742210789338,758.5,63,1150,1087,2152791
PI595717,1016.6941176470588,1057.5,239,1481,1242,3098066
PI595717,1183.12310344238,1199,188,2403,2215,3165360
PI533822,818.5065359477125,811,479,958,479,2403689
PI533822,741.4866013071896,777,271,931,660,2259422
PI533822,995.3506535947713,1009,480,1071,591,3038624
PI533829,733.6184724495363,774.5,2,897,895,1134877
PI533829,906.6217884148116,939,2,1333,1331,2205968
PI533829,834.2154641039551,869,91,1994,1903,2352013
PI656025,871.8807190890266,954,3,1224,1221,1233480
PI656025,884.0872549019607,910.5,191,1290,1099,2617373
PI533862,901.2135890584048,981,3,1208,1205,2143131
SC1216,987.5316993464053,983,838,1154,316,3016796
SC1216,765.9680230809199,759.5,221,1004,783,2190896
SC1216,843.3415032679738,827,680,1094,414,2567153
PI533873,869.2868468830927,998.5,3,1222,1219,1249375
PI533873,1308.1519301042574,1358,519,1568,1049,3435161
PI533873,1313.5196078431372,1321,1052,2183,1131,3965519
PI655977,1410.3631478248071,1426,334,1639,1305,4180221
PI655977,1349.7663260672116,1359.5,3,1539,1536,3954091
PI655977,1477.5057753986175,1513,824,1718,894,4169695
PI659696,412.09794922171477,416,120,1002,882,1219551
PI659696,784.6660130718953,794,582,901,319,2397201
PI659696,1555.1565359477124,1561,1358,1710,352,4737316
PI533807,1341.2045027345157,1421,329,1683,1354,3018557
PI533807,1280.9212418300654,1302,781,1680,899,3785510
PI533807,591.1854486969908,580,2,814,812,1054615
PI534080,287.31247091282563,323,3,436,433,309946
PI534080,101.4,107,6,134,128,6588
PI534080,129.094726062468,138,15,147,132,6240
PI642793,852.9728758169935,887,371,1072,701,2588814
PI642793,563.5008982903506,510,93,962,869,1631651
PI642793,716.3722429692667,725,279,1250,971,1933064
PI533811,885.4331769790549,956,2,1153,1151,1946634
PI533811,395.1640230030334,397.5,5,642,637,293135
PI533811,350.06813286746757,349,9,459,450,671634
PI533781,786.6000560632338,823,8,909,901,1910213
PI533781,434.48628559236056,460,8,550,542,787161
PI533968,406.1437724683369,410,2,602,600,1056955
PI533968,640.694732489663,683,3,741,738,929281
PI533830,828.0251633986927,814,370,941,571,2438592
PI533830,232.38567164179105,242,3,301,298,33610
PI533830,951.1895669735068,1023,2,1205,1203,1815688
PI534098,334.69647696476966,378,56,402,346,176234
PI534098,435.13374034350284,468,5,594,589,979760
PI597972,625.5093560244477,707,2,742,740,692921
PI597972,1023.2576258129388,1110,322,1311,989,2217773
PI597972,930.2411764705882,938,644,1058,414,2841898
SC0409,584.6921048549713,650,5,833,828,1066218
SC0409,746.174910925806,798,3,936,933,1310872
SC0409,948.801458956464,1003,336,1131,795,2664915
PI534067,859.0310012333222,887,5,1081,1076,2095058
PI534067,1251.4621509209744,1319,336,1595,1259,2838718
PI534067,1016.3130718954249,939,793,1323,530,3106327
SC0848,892.2091503267974,915,411,1088,677,2720327
SC0848,762.5881067477776,723,389,1098,709,1989620
SC0848,727.2962340061587,799,4,926,922,2099609
PI576375,367.90039672888275,402,2,508,506,215790
PI576375,1128.138998153554,1134,2,1429,1427,2604312
PI576375,428.0441649799816,518,3,652,649,468197
SC0551,219.71561971956243,249,3,328,325,104319
SC0551,889.9814449417081,857,4,1318,1314,2342433
SC0551,1092.0244919541988,1113,3,1353,1350,2055785
PI534082,907.9640522875817,951,624,1041,417,2769022
PI534082,574.5462018903979,613.5,3,730,727,980048
PI534082,694.3287404367431,716,395,808,413,1789563
PI656024,162.8840383574356,174,16,220,204,36401
PI656024,606.6419941535164,633,6,853,847,515577
PI533762,1301.751633986928,1306.5,1107,1978,871,3977456
PI533762,1203.49477124183,1231.5,972,1358,386,3676385
PI533762,948.6522875816993,940,846,1032,186,2901112
PI561071,1251.4354700854701,1261.5,489,1391,902,3577117
PI561071,926.5253647741749,934,351,1044,693,2776958
PI561071,1120.254507881584,1128,581,1288,707,3087999
SC0999,1078.350736654721,1130,5,1213,1208,810235
SC0999,319.3930948577514,350.5,2,456,454,98841
SC0999,756.9788787805691,778,277,862,585,2210228
PI655981,1008.135294117647,944,772,1329,557,2864224
PI655981,925.318954248366,947,575,1478,903,2768871
PI655981,1186.770321415377,1309,606,1405,799,3364286
PI534090,1164.6742099098415,1230,2,1492,1490,2447789
PI534090,1019.8686971148945,1073,482,1196,714,3045552
PI534090,1041.9565359477124,1079,445,1261,816,3119740
PI533857,1393.2287581699347,1448,740,1639,899,4136368
PI533857,1471.2519607843137,1493,1045,1646,601,4456839
PI533857,1352.56568627451,1372,1074,2271,1197,4119795
PI576399,258.57390083357393,297,3,412,409,180747
PI576399,256.8538618341711,311,5,387,382,73094
PI576399,310.4274415457484,349,2,392,390,150086
PI534100,1227.5176470588235,1145,953,1581,628,3716535
PI534100,1389.682964806318,1472,3,1646,1643,3653921
PI534100,1054.8470588235296,1067,727,1237,510,3218399
PI534120,1141.9254901960785,1191,735,1486,751,3488785
PI534120,945.9676470588236,950,508,1240,732,2844875
PI534120,1145.0116012739527,1246,2,1361,1359,2453826
PI576429,793.6908903956182,787,335,927,592,2345632
PI576429,819.9094174366686,832,444,944,500,2474948
PI576429,406.62339869281044,426,269,450,181,1046691
PI595722,1217.7366013071896,1204,1024,1363,339,3723776
PI595722,1091.5545751633986,1056,724,1323,599,3336285
PI595722,1133.6367496179873,1181.5,310,1357,1047,3444065
PI576361,1045.9211018657627,1049,260,1256,996,3048734
PI576361,745.0529411764705,782,145,1030,885,2021177
PI576361,1402.6680007813573,1444,749,1681,932,3683264
PI533747,761.2540259423096,749,86,1313,1227,2195054
PI533747,1156.5592747522055,1164,366,1408,1042,3368810
PI533759,1299.412467068384,1403,355,1678,1323,3863311
PI533759,1366.26045751634,1377,713,1555,842,4109577
PI533759,1215.4186274509805,1226,897,1340,443,3714356
PI576405,1284.1328729192828,1351,321,1596,1275,3813116
PI576405,1252.0669934640523,1219.5,216,1847,1631,3770423
PI576405,994.9181024129273,1017,166,1266,1100,2931351
SC0540,1053.1274204365982,1098,4,1264,1260,1918167
SC0540,988.8356209150327,990.5,730,1159,429,3023760
SC0540,1017.2944444444444,1022,788,1166,378,3110638
PI533984,1226.4101307189544,1244,851,1424,573,3749434
PI533984,781.4751633986928,790,294,1042,748,2337826
PI533984,1043.9356209150326,1059,687,1327,640,3034702
PI597955,653.7081762058057,678.5,324,972,648,1820112
PI597955,685.4627450980392,738,117,1079,962,2083946
PI597955,1236.0941176470587,1226.5,636,1399,763,3770546
PI534122,1108.6176470588236,1135,944,1215,271,3377704
PI534122,789.19477124183,841,429,1154,725,2350960
PI534122,613.4535947712418,617,399,898,499,1813070
PI595731,673.4997487960152,755,2,853,851,1446946
PI595731,1329.2264705882353,1356,497,1887,1390,3931206
PI595731,1197.924049999285,1224,423,1514,1091,3123427
PI576415,824.1876068376068,849,532,964,432,2163668
PI576415,864.2488805879348,927,407,1115,708,2294760
PI656010,978.328431372549,990,728,1653,925,2971429
PI656010,694.7689542483661,686,351,957,606,2070883
PI656010,915.4836601307189,914,630,1069,439,2768720
PI533996,1002.452306106391,1063,2,1114,1112,1287209
PI533996,537.5318106259058,574,2,685,683,753486
PI533996,1061.9799547667324,1083,3,1195,1192,2962657
PI534113,1175.9251075761308,1227,3,1277,1274,2462611
PI534113,1100.393483377464,1158,2,1286,1284,1792732
PI534113,1325.1501762761518,1363,2,1453,1451,3601748
PI595718,860.7598039215686,868,648,949,301,2633404
PI595718,938.3434640522876,971,547,1036,489,2868008
PI595718,1543.7469928201167,1583,651,1671,1020,4705288
PI533929,1135.4686274509804,1163,603,1305,702,3403259
PI533929,991.9413292505332,1070,4,1230,1226,1424001
PI533929,813.6438496566466,868,2,1031,1029,940274
PI656055,1052.186274509804,1057,622,1193,571,3209715
PI656055,1226.83930836016,1249,1071,1286,215,3499755
PI656055,1265.519810365461,1269,488,1402,914,3626133
PI534121,1454.6305193709393,1447,227,1649,1422,4419770
PI534121,1808.8765239977388,1844,607,1964,1357,5507322
PI534121,1545.2951952565495,1580,59,1698,1639,4689410
PI534137,1243.2437772958647,1303,330,1351,1021,3786933
PI534137,1866.1826686783418,1882,62,2051,1989,5507393
PI534137,1867.7408978489395,1941.5,86,2165,2079,5509946
PI533851,1499.5283318425281,1529,601,1707,1106,4558128
PI533851,896.2091323359766,888,35,1075,1040,2725899
PI533851,966.881045751634,942,489,1292,803,2952474
PI576369,1903.9171689162176,1970,111,2107,1996,5790897
PI576369,1651.5551916158693,1641,97,1852,1755,4997990
PI576369,1612.7086860847694,1643,50,2888,2838,4867323
PI533852,1284.5403218177516,1323,2,1499,1497,3200367
PI533852,1260.944816883923,1263,159,1494,1335,3826796
PI533852,1136.049019607843,1136,171,1319,1148,3460989
PI534072,643.4291508532297,673,2,747,745,1267161
PI534072,668.7384135472371,677,240,714,474,1801218
PI534072,701.7117647058824,699,608,777,169,2142265
PI655986,1181.7849673202613,1175,514,1737,1223,3605044
PI655986,1390.6275960088178,1414,81,1533,1452,4237538
PI655986,1214.1915953205532,1230,434,1387,953,3705969
PI533930,1655.785516406224,1675,787,1739,952,4902324
PI533930,1635.4088235294116,1636.5,649,1827,1178,4994440
PI533930,1566.6065359477125,1585,943,1631,688,4535616
PI533788,583.3018968620158,585,88,767,679,1767894
PI533788,1221.8412054476962,1249,315,1369,1054,3689032
PI533788,1058.0496732026145,1037,586,1270,684,3233270
PI597956,793.6756528657818,814,79,947,868,2396049
PI597956,793.1100285655989,813,89,946,857,2396477
PI595734,1860.8541947550298,1914,11,2001,1990,5610959
PI595734,1152.0059314905652,1172,145,1311,1166,3498073
PI595734,2050.928620755826,2079,90,2357,2267,6191176
PI576427,1149.9057541403977,1150,531,1256,725,3503708
PI576427,1574.1905840227137,1624,76,1766,1690,4788906
PI576427,1229.5478115263286,1236.5,24,1409,1385,3739405
PI533837,1075.7024698016705,1110,42,1201,1159,3251117
PI533837,1497.120334485147,1576,3,1729,1726,3769913
PI533837,1200.6476442048868,1201,220,1485,1265,3601790
PI533745,708.6507247344003,718,283,824,541,2158213
PI533745,815.8877348602957,828,66,917,851,2469711
PI533745,602.4669109417792,595,132,748,616,1824489
PI533963,965.2530750124193,983,193,1072,879,2713219
PI533963,1355.3283448659024,1370,221,1400,1179,3874654
PI533963,1040.049019607843,1036,895,1184,289,3180653
PI533912,1189.1975349971535,1206,111,1414,1303,3612361
PI533912,860.5368748318436,860,132,1004,872,2379746
PI533912,830.5093888300261,827,332,1203,871,2410225
PI533918,1348.619968224444,1351,121,1537,1416,4096086
PI533918,1167.1362162432388,1269,8,1443,1435,3529550
PI533918,1871.8509103341926,1913,65,2066,2001,5690784
PI576330,1009.6584748597602,987,418,1215,797,3057945
PI576330,905.3866013071895,932,431,1086,655,2765746
PI576330,764.5813915326551,781,76,809,733,1990079
PI656006,1359.5832567706102,1413.5,119,1539,1420,4122108
PI656006,1106.148336646786,1111,17,1253,1236,3352409
PI656006,972.4148088106633,975,406,1108,702,2920393
PI534001,1220.6079198338389,1249,100,1320,1220,3698037
PI534001,771.3640522875817,753,628,1001,373,2349934
PI534001,1093.4921513499519,1130,81,1262,1181,3320188
PI564165,1002.8934994392059,1019,264,1216,952,3034793
PI564165,1303.0880924183903,1320,570,1477,907,3876532
PI564165,1386.4176209620803,1432,7,1604,1597,3961658
PI576368,950.3529250250347,1008,24,1146,1122,2877271
PI576368,1148.3477502467656,1229,79,1329,1250,3443702
PI576368,1012.5727141312004,1037,136,1246,1110,2654101
PI533946,1201.5956766283864,1249,140,1419,1279,3558652
PI533946,1056.060719882188,1073.5,103,1231,1128,3189866
PI533946,735.4243186849874,735,164,953,789,2223478
PI533869,1291.2495371263258,1292,375,1400,1025,3940941
PI533869,1050.7340644900435,1045,118,1178,1060,2964722
PI533869,845.818654520931,872,139,1113,974,2563089
SC0847,1316.4624846137583,1313,70,1550,1480,3680532
SC0847,911.199950373489,950,123,1115,992,2747145
SC0847,734.9216365082136,770,77,948,871,1998524
PI534054,1630.0668535380305,1617,21,2764,2743,4837161
PI534054,1048.215625100615,1067,315,1308,993,3193313
PI534054,1463.1856209150328,1439.5,1019,1656,637,4473092
PI656018,1065.0039215686274,1065,192,1157,965,3004925
PI656018,1170.9738562091504,1175,390,1276,886,3328577
PI656018,973.5916927319502,980,68,1483,1415,2595568
PI656018,1151.558591445893,1183,3,1401,1398,3010583
PI656018,1486.0783420668495,1512.5,76,1840,1764,4402959
PI656018,1421.3350967333108,1412.5,9,2259,2250,4242035
PI656031,1320.6974001560616,1326,105,1390,1285,3760300
PI656031,1560.484509247124,1588,26,1712,1686,4504758
PI656031,1268.0397750063812,1279,93,1372,1279,3602584
PI597961,1657.4095919186425,1667.5,42,1825,1783,5022235
PI597961,1376.2426999907946,1411,47,1512,1465,3940653
PI597961,1828.8849141955634,1895,118,2008,1890,5540256
PI533851,994.1698632159932,890,60,1266,1206,2770470
PI533851,1093.4472222222223,1128,332,1238,906,2972273
PI533851,1032.9547178495811,994,246,1280,1034,2860292
PI534036,1495.7715564287273,1528,274,1632,1358,4305143
PI534036,1946.9632151490732,2015,60,2079,2019,5672009
PI534036,1928.6183257918549,1939.5,552,2158,1606,5634211
PI534048,1824.4884226679824,1835,18,2010,1992,5246127
PI534048,1522.5696078431372,1588,303,1682,1379,4398903
PI534048,1737.3400631448076,1775,86,2046,1960,5083752
PI534147,1396.4366386737056,1422,4,1576,1572,3926769
PI534147,1154.6010441171732,1237,2,1345,1343,2159873
PI534147,980.2846477936286,1043,10,1327,1317,2707737
PI534122,1368.3956907950544,1381,12,1539,1527,4155713
PI534122,1555.8583333333333,1592.5,63,1702,1639,4486754
PI534122,1675.6419934640523,1715,503,1893,1390,4840789
PI656101,721.4082886410074,733,37,754,717,1937998
PI656101,885.1906613182346,896,17,989,972,2657203
PI656101,845.469588793,854,75,972,897,2558320
PI534009,1533.387304018716,1585,207,1662,1455,4654792
PI534009,1346.547818902842,1358.5,430,1536,1106,4090358
PI534009,1355.7909366949655,1410,20,1587,1567,3830762
SC0604,1073.5333333333335,1092.5,188,1202,1014,2932895
SC0604,1217.8217276099629,1270,212,1428,1216,3470147
SC0604,1218.9292694213689,1260,20,1382,1362,3458088
PI595719,1553.1395022048978,1569,72,1742,1670,4549120
PI595719,1533.735509971034,1615,4,1825,1821,4427313
PI595719,2008.742977887407,2080,23,2253,2230,5917493
PI597968,1218.0403655449802,1213,33,1432,1399,3691808
PI597968,531.4557617608976,538.5,27,771,744,1314751
PI597968,761.4282033278798,732,27,961,934,1998574
PI595732,1955.211055332224,1991,275,2181,1906,5939558
PI595732,1863.613071895425,1866,972,2018,1046,5697442
PI595732,2130.911111111111,2206,1207,2345,1138,6488048
PI576389,1277.9191176470588,1286,130,1455,1325,3632213
PI576389,871.9861567455923,905,13,946,933,2280405
PI576389,1063.1050653594773,1101,144,1154,1010,2998834
PI534005,1549.874248366013,1552,608,1761,1153,4410449
PI534005,1163.7444444444445,1160,18,1345,1327,3220687
PI534005,951.6623122538199,993,14,1100,1086,2652182
PI533807,1618.69560974357,1638,227,1736,1509,4851541
PI533807,1122.4748366013073,1102,466,1325,859,3428052
PI533807,1301.1157114873645,1343,499,1402,903,3924020
PI655978,1241.0547385620914,1286,510,1396,886,3540455
PI655978,942.20644312952,945,26,1120,1094,2612804
PI655978,1146.7201796047602,1155,39,1252,1213,3242399
PI655977,1272.7853344077357,1354.5,151,1593,1442,3633557
PI655977,1665.1553921568627,1686,75,1788,1713,4826491
PI655977,1642.0738152786935,1671,593,2875,2282,4984253
PI656017,1099.1745218161655,1140,15,1287,1272,3350239
PI656017,1287.9676911661404,1318,14,1404,1390,3912253
PI656017,1072.7283438834852,1053,229,1218,989,3268678
PI656017,1070.705506664608,1050,245,1217,972,3262630
PI533978,1361.4469389371645,1450.5,62,1579,1517,4148534
PI533978,1148.9075825840405,1172,115,1275,1160,3464785
PI533978,1144.8885858272,1165,115,1272,1157,3454497
PI533871,1063.2984504663289,1063,40,1229,1189,3232913
PI533871,943.7516960101559,934,31,1095,1064,2618008
PI533871,927.9365750546879,925,43,1082,1039,2816393
PI595740,2111.0080840262126,2095,611,2297,1686,6389100
PI595740,1282.979353014614,1298,49,1398,1349,3900377
PI595740,1634.2333720075803,1652.5,808,2007,1199,4983881
PI576401,1775.3563292430244,1793.5,8,2942,2934,5327347
PI576401,1214.8735160555102,1245,106,1343,1237,3697737
PI576401,1391.1883614336707,1429,37,1603,1566,4213183
PI533986,938.0365741817149,958,206,1041,835,2851966
PI533986,1058.3794117647058,1109,716,1280,564,2918023
PI533986,833.2248741380555,838,88,959,871,2521356
PI533776,864.5801634055008,885,25,1013,988,2595748
PI533776,1231.927087442472,1247,58,1369,1311,3739217
PI533776,1078.3966578623877,1110,32,1228,1196,3248465
PI533948,1088.3945720407878,1094,203,1893,1690,3310515
PI533948,1583.163087177439,1668,22,1743,1721,4556592
PI533948,1670.9701853618644,1697,501,1843,1342,5066944
PI597975,929.0505881850756,947,117,1053,936,2626763
PI597975,809.7918571306388,818,13,934,921,2333389
PI597975,1285.5549418795022,1327.5,38,1472,1434,3493007
PI576437,1162.9088813620365,1205.5,129,1320,1191,3533381
PI576437,720.0121349680685,734,30,860,830,1962974
PI576437,1050.5410869429543,1079,41,1139,1098,3198345
PI597978,1122.9472523134223,1145,42,1204,1162,3294587
PI597978,806.2788646689512,815,162,871,709,2439601
PI597978,1278.754309842749,1283,130,1464,1334,3873260
PI542718,998.8794167869767,1024,59,1344,1285,2568943
PI542718,1269.5239264288075,1360,13,1620,1607,3482184
PI542718,1098.3050562091503,1104,93,1378,1285,2545440
PI597949,1155.753336192021,1208,148,1325,1177,3497609
PI597949,1381.566012642464,1410,31,1509,1478,4206236
PI597949,1295.9849664628068,1293,301,1406,1105,3949636
PI533755,963.908198968959,977,77,1060,983,2937460
PI533755,1092.3890530703397,1089,12,1223,1211,3318969
PI533755,965.7732490949596,1003,31,1055,1024,2927393
PI656053,1177.1529741383395,1228,3,1306,1303,3010685
PI656053,1424.9460071182002,1570,5,1705,1700,3664534
PI656053,929.4712418300654,936,122,1053,931,2579185
PI595721,1161.9473455508096,1198,76,1278,1202,3516599
PI595721,1100.974564489416,1170,6,1327,1321,2671530
PI595721,1394.2816315774062,1433,2,1547,1545,3823329
SC0247,1231.571510161159,1276,86,1395,1309,3725757
SC0247,965.6142039537357,993,12,1131,1119,2833167
SC0247,938.7773411918795,950,29,1128,1099,2865169
PI533936,1475.1714309268677,1501.5,4,1617,1613,3237622
PI533936,1201.84799368196,1226,2,1378,1376,2750338
PI533936,298.0489463601533,312.5,23,414,391,67619
PI534095,772.345325924633,781,287,893,606,2348064
PI534095,1033.6990524895075,1064,70,1176,1106,2841336
PI534095,861.3824983085137,884,291,944,653,2522976
PI597967,2214.974779342545,2257,7,2486,2479,6655060
PI597967,2202.0741973600284,2214,23,2451,2428,6643175
PI597967,1831.411683006536,1861,782,1952,1170,5566232
PI534157,1113.1076073464835,1147,40,1221,1181,3368572
PI534157,1847.5472096695978,1882,780,2014,1234,5631255
PI534157,1520.1416213953307,1562.5,77,1666,1589,4617739
SC0914,1128.3523001453318,1190,67,1359,1292,2683814
SC0914,1140.752321322302,1203,8,1362,1354,3005061
SC0914,1015.3141958059291,1066,2,1209,1207,2091589
SC0914,1723.397644889012,1789,25,2006,1981,3849234
PI656088,186.8398024691358,196,5,295,290,62644
PI656088,1005.8077288302811,1070,2,1238,1236,1648980
PI656088,591.2550834178037,632,2,749,747,707829
PI533913,591.3793899177974,628,2,935,933,505580
PI533913,582.2899060850064,624,2,885,883,485835
PI533913,793.9772555810844,884,2,1003,1001,366690
PI533913,838.9937794937796,869,2,1061,1059,1761293
SC1170,170.14319890635682,180,24,183,159,12987
SC1170,664.1399306700371,725,3,886,883,667358
SC1170,1078.318966151442,1134,2,1288,1286,1243224
PI656103,1086.88290196553,1113,3,1248,1245,2710941
PI656103,1196.813524264121,1251,2,1326,1324,2244499
PI656103,440.41224097303643,479,2,591,589,272172
PI576360,882.7216582782937,914,3,1002,999,1983121
PI576360,779.4044351685628,867,2,1025,1023,817453
PI576360,704.1349986349987,791,2,974,972,682098
PI576360,1487.9203596241477,1563,2,1636,1634,2584620
PI534166,170.75713213213214,176,58,179,121,12435
PI534166,168.0363470319635,176,23,177,154,12392
PI534166,159.70159725332138,171,7,177,170,19590
PI533818,876.4012823270862,936,2,1009,1007,1598705
PI533818,665.7430606821883,659,4,774,770,1745932
PI533818,1171.2891226846468,1185.5,329,1470,1141,3566197
PI533818,1171.6038935912418,1185,249,1471,1222,3567640
SC0156,1235.8309831547185,1291.5,5,1443,1438,3016101
SC0156,1319.1212070047418,1343,125,1484,1359,3999850
SC0156,1238.0899862941842,1309,2,1429,1427,2839872
SC0156,1307.1544022676135,1362,88,1456,1368,3679938
PI533813,1060.8284092731265,1247,2,1391,1389,1171998
PI533813,1326.396696974367,1496.5,7,1864,1857,3082596
PI533813,1762.109864051705,1891.5,97,2057,1960,4631460
PI595712,862.2234894329631,867,3,1292,1289,2602918
PI595712,991.8176415819587,1039,3,1133,1130,2330395
PI595712,1198.9774206812967,1213.5,219,1301,1082,3637006
SC0777,1547.726116880976,1652,2,1881,1879,3071856
SC0777,1217.4778776845938,1267,2,1368,1366,3167404
SC0777,1442.2417768028304,1505,4,1627,1623,3595262
PI533894,779.2022672291043,803,3,901,898,2127378
PI533894,290.7154359141185,337.5,2,405,403,61853
PI533894,633.0642103901145,655,3,731,728,1008690
PI656093,807.6392858668542,842,2,931,929,1943279
PI656093,968.4170597920171,980,4,1096,1092,2648325
PI656093,1152.8243975318378,1171,3,1338,1335,2936421
PI533876,678.3553326443528,683,87,765,678,2049137
PI533876,682.5636675906865,713,3,853,850,1679765
PI533876,807.9665120207848,852,2,995,993,2061852
PI534040,1696.365964687468,1762,3,1843,1840,4209316
PI534040,1639.5196037230103,1696,2,1848,1846,3904553
PI534040,984.5059452325488,1035,6,1074,1068,2319470
PI534016,959.243114292416,995,30,1095,1065,2663680
PI534016,1728.1698083284246,1781,2,1962,1960,5184085
PI534016,1587.5894393230838,1656,2,1851,1849,3491762
SC1442,376.4177675033025,380,44,419,375,882674
SC1442,756.2961067077645,767,36,839,803,1952504
SC1442,1021.0141636015362,1105,20,1353,1333,2982809
PI533819,692.8998552330452,724,152,846,694,2083409
PI533819,921.0845347313237,952,16,1062,1046,2795470
PI533819,1521.0713832431707,1583,51,1704,1653,4575589
PI533819,1499.7867653176481,1571,5,1694,1689,4481105
PI533938,1392.882942165565,1449,33,1590,1557,3872619
PI533938,1149.6928685371252,1173,5,1302,1297,3435657
PI533938,1026.0533943458972,1050,2,1221,1219,2579643
PI533928,1659.4671737009808,1691,9,1867,1858,4423413
PI533928,1777.444347826554,1835,6,2101,2095,4139385
PI533928,1042.7840903099263,1082,9,1222,1213,2577387
PI656071,1095.345281123371,1188,3,1427,1424,1844694
PI656071,1198.8968088011425,1222,5,1397,1392,3095297
PI656071,1217.4509330155192,1267,3,1473,1470,3227412
SC0287,782.752173275941,792,40,929,889,2359363
SC0287,403.5391586875054,408,24,463,439,961945
SC0287,717.8440162762564,717,84,776,692,1906368
PI595704,1556.1622059522044,1563.5,81,1767,1686,4699835
PI595704,1250.0625683342819,1275,57,1415,1358,3791637
PI595704,1518.7458828268727,1542.5,533,1633,1100,4594834
PI659691,1343.107271627794,1366,118,1520,1402,4062745
PI659691,1392.5300761805747,1500,14,1562,1548,3382673
PI659691,1322.1982916437355,1362,243,1544,1301,4022648
PI564163,1212.5834045169222,1195,173,2117,1944,3677391
PI564163,1917.0647461465164,1973,103,2035,1932,5812778
PI564163,1263.490037017757,1305,74,1504,1430,3603041
PI576418,1008.4289853038679,1011,66,1325,1259,2694341
PI576418,1370.527552772889,1391,77,1583,1506,3936788
PI576418,1398.6827270079482,1396,31,1527,1496,4229006
PI533916,415.82245521455354,430,10,446,436,1006253
PI533916,745.2843688490335,785,4,886,882,2207612
PI533916,961.8305383985032,1013,30,1107,1077,2844158
PI534087,1436.595196140967,1569,9,1718,1709,3797569
PI534087,1036.066962996878,1091,40,1226,1186,2443373
PI534087,486.4313725363698,519,2,664,662,820563
PI597971,1394.0114262930051,1478,3,1615,1612,3659373
PI597971,1418.4206381103295,1515,3,1606,1603,3897075
PI597971,1063.5523163087034,1043,7,1310,1303,3057450
PI533854,448.82735952166644,492.5,8,552,544,365880
PI533854,443.1661387069132,485,4,548,544,394556
PI533854,414.18349726775955,453,7,510,503,137251
PI533854,916.6729503339027,994,3,1088,1085,1218698
PI576430,703.7252960265378,741,18,835,817,1831232
PI576430,1108.7671654497658,1135,3,1355,1352,3314583
PI576430,1012.9868954035703,1027,29,1142,1113,3058734
PI576430,990.1212222566535,1021,3,1132,1129,2885576
PI597973,1327.0493464052288,1337,175,1491,1316,4047609
PI597973,1449.308152631374,1510,54,1646,1592,4079677
PI597973,1239.246538948944,1273,20,1420,1400,3603418
PI533885,400.9427235272469,406,9,446,437,952004
PI533885,758.812623769084,779,3,976,973,2083341
PI533885,744.5204537543323,724,145,902,757,2265011
PI597954,976.2627765626379,1016,4,1138,1134,2385113
PI597954,861.6124987223998,869,4,962,958,2587216
PI597954,1437.210928260193,1479.5,427,1591,1164,4357232
PI576370,713.5897369445577,728,4,835,831,2072405
PI576370,1431.7252782882497,1481,20,1586,1566,4095963
PI576370,852.361249836119,869,17,1055,1038,2588888
PI534037,738.6185517303533,754,47,787,740,1985467
PI534037,606.0310457516339,617,45,675,630,1591682
PI534037,779.6817346758522,780,389,846,457,2129862
PI576353,1211.760022295602,1227,66,1409,1343,3663836
PI576353,995.7248710010319,1013,307,1140,833,3027551
PI576353,1257.2555110374487,1284,38,1454,1416,3680994
PI534107,1514.6293566695347,1521.5,334,1655,1321,4601117
PI534107,1164.8352479866176,1176,470,1344,874,3543408
PI534107,1271.6423401408042,1286,25,1979,1954,3859010
PI576426,1211.9672849938854,1230.5,454,1371,917,3563346
PI576426,1100.9811108610838,1122,59,1214,1155,3339132
PI576426,1132.297444692863,1148,425,1247,822,3438333
SC0713,1429.2933429361156,1449,539,1501,962,4337070
SC0713,1221.044582297029,1226,194,1396,1202,3723399
SC0713,1047.2617030480287,1051,322,1239,917,3187973
PI656097,1744.393746498928,1774,687,1946,1259,5249546
PI656097,1265.288607300628,1309,30,2046,2016,3792467
PI656097,1829.6886816041251,1800,551,3022,2471,5386605
PI534154,1456.533086124402,1542.5,3,1625,1622,3039314
PI534154,1303.261143791699,1331,11,1480,1469,3549387
PI534154,1525.4345548008027,1532,11,1654,1643,4630733
PI534148,1326.4193820965515,1377,20,1530,1510,2734316
PI534148,1502.5648753462606,1576,18,1747,1729,3902405
PI534148,1459.2445290040089,1458,9,1697,1688,4161865
PI655997,1371.2242145083412,1468,11,1578,1567,3835471
PI655997,1299.9924947387908,1314,28,1409,1381,3718233
PI655997,1221.162691887514,1261,540,1396,856,3553042
SC0436,959.1216665916395,1021,168,1106,938,2910204
SC0436,866.8434113430319,889,41,1005,964,2391305
PI533829,1471.2503103120575,1479,676,1614,938,4473616
PI533829,1255.9209273239703,1279,517,1374,857,3820714
PI533829,1100.7321215716365,1108,426,1249,823,3349677
PI659694,1116.9969993763984,1136,18,1202,1184,3392595
PI659694,1206.5467320261437,1217,711,1366,655,3673296
PI659694,1562.8532791652078,1631,43,1799,1756,4762077
PI534110,1178.8055242262194,1216,298,1331,1033,3576199
PI534110,1107.1653037693438,1122.5,118,1279,1161,3364040
PI534110,1180.7769200961015,1236,75,1300,1225,3589109
PI534113,1153.1696308750898,1182,27,1255,1228,3494591
PI534113,1409.9256125168877,1453,524,1569,1045,4296391
PI534113,1279.486884288166,1296,337,1388,1051,3901361
PI656092,1727.686579888493,1757.5,74,1892,1818,5241108
PI656092,1664.7460124648312,1714.5,260,1813,1553,5039938
PI656092,1218.9548759078007,1251,143,1395,1252,3701968
PI533995,1025.3106607574223,1033,32,1108,1076,3093300
PI533995,840.4650381966756,811,118,979,861,2549870
PI597974,843.7025499401639,843,159,943,784,2248266
PI597974,879.3746799412606,888,261,926,665,2667786
PI597974,789.1862622306669,785,281,879,598,2389834
PI533998,798.992570784508,803,47,927,880,2428658
PI533998,881.3320261437908,911,359,1036,677,2687989
PI533998,1168.604445664602,1198,37,1257,1220,3550919
PI533906,1091.299837413159,1084,457,1267,810,3290859
PI533906,1183.8544117647054,1185,937,1237,300,3350866
PI533906,1477.9368104960765,1499.5,543,1740,1197,4501283
PI534126,1294.0044274109775,1329,55,1419,1364,3930479
PI534126,1137.5447312787642,1153,66,1298,1232,3200398
SC0542,1005.9623956886434,1029,133,1128,995,3060636
SC0542,1032.599143937628,1047,9,1097,1088,3140723
SC0542,1321.9579036901841,1339,215,1501,1286,4023261
PI533766,1056.6358680484493,1055,317,1153,836,2940229
PI533766,1110.8524077755687,1112,339,1243,904,3370665
PI533766,925.8905486756107,938.5,403,987,584,2814956
SC0470,1242.035857899742,1258,119,1380,1261,3781138
SC0470,1029.9086249429752,1037,66,1146,1080,3127624
SC0470,1474.4479783053503,1521,126,1608,1482,4472867
PI576364,1172.3846993274824,1180,3,1281,1278,3554844
PI576364,999.5692810457517,1019,542,1141,599,3038604
PI576364,1098.8335081143714,1105,342,1878,1536,3319493
PI533939,909.0275673021847,906,8,1084,1076,2737886
PI533939,1261.9425387864503,1275,461,1366,905,3840266
PI533939,1012.2866972477065,1024,24,1209,1185,3085154
PI576329,1306.5504684632474,1319,261,1498,1237,3978491
PI576329,1376.1723942208464,1388,33,1535,1502,3952206
PI576329,1673.3456862745097,1686,61,1848,1787,4846099
PI656048,1227.5654695945873,1267,18,1367,1349,3499691
PI656048,1944.2576200629833,1981,220,2097,1877,5919882
PI656048,1353.623322286661,1410,7,1488,1481,3882633
PI534004,1315.9596092599018,1344,30,1436,1406,3948582
PI534004,1173.5009565638438,1198.5,28,1356,1328,3540768
PI534004,1413.5331100757135,1388.5,301,1591,1290,4299166
PI534164,1014.0097806481642,1035,302,1135,833,3079547
PI534164,405.3935718077771,389,4,598,594,522851
PI534164,716.3848727965642,733,25,791,766,2054706
PI656063,1828.5365274946985,1939,2,2154,2152,3354513
PI656063,1475.5336044486194,1544,2,1671,1669,3135925
PI656063,1392.023815404439,1438,58,1557,1499,4227231
PI656079,1341.4745200690415,1344,4,1516,1512,3878619
PI656079,1219.7875816993464,1270,383,1467,1084,3727326
PI656079,1076.6092787353523,1080,11,1285,1274,2946709
PI595746,1421.316845351871,1431,95,1548,1453,4309782
PI595746,1231.6967195694983,1254,81,1349,1268,3735777
PI595746,1302.2048789225034,1327,30,1435,1405,3935469
PI656029,1032.1049795093472,1069,16,1173,1157,3113342
PI656029,1280.0074718863568,1294,12,1482,1470,3800456
PI656029,991.7605012880656,1007,32,1157,1125,3004608
PI533838,147.01681372889598,157,12,174,162,29997
PI533838,124.68792756539236,135,16,164,148,6904
PI533764,645.2421622929216,676,2,838,836,1429866
PI533764,873.4385651960072,887,22,992,970,2642934
PI533764,998.8189722265718,1006,31,1193,1162,2605695
SC1082,172.23287671232876,179,26,182,156,12573
SC1082,172.60273972602738,179,40,182,142,12600
SC1082,1399.7039611984142,1400,5,1594,1589,4126013
PI576405,167.61457872622734,176,2,245,243,137241
PI576405,1124.7283797414707,1184,4,1338,1334,1457876
PI576420,453.45801375912237,471,39,518,479,437079
PI576420,1155.1528323494508,1203.5,9,1330,1321,3099144
PI595747,1094.3240116798477,1152,2,1207,1205,2651228
PI595747,1272.5316385089031,1317,3,1404,1401,3696930
PI595747,1456.9453979610048,1521,37,1653,1616,3966325
PI533957,1141.270876586988,1193,2,1352,1350,1685773
PI533957,1165.8128845088618,1206,4,1338,1334,2478366
PI534046,348.70904707524426,367,67,431,364,233049
PI534046,992.0138244188031,1087,2,1177,1175,1781491
PI534046,1011.840673757915,1065,2,1146,1144,1023226
PI533889,825.8463122107461,873,5,945,940,1744705
PI533889,171.73024256651019,176,80,177,97,12244
PI533889,599.3370073692699,627,2,700,698,734232
PI533900,593.4430720725704,643,2,746,744,862510
PI533900,758.2718785635691,786.5,2,912,910,1054154
PI533900,804.903076871246,824,32,965,933,2285002
SC0823,172.57282282282281,178,27,182,155,12573
SC0823,196.5891514500537,199,30,250,220,47873
SC0823,1248.1042724332196,1306,8,1416,1408,2791430
SC1216,591.4598578781754,627,3,691,688,377680
SC1216,214.06060119983317,240,8,284,276,60808
SC1216,400.1207596751075,426,2,627,625,333271
PI565121,485.2610442961135,570,3,643,640,201081
PI565121,1385.4038263428993,1386,189,1542,1353,4203458
PI565121,1712.083660130719,1756,412,1909,1497,5222168
PI534072,375.14460273337966,417,55,453,398,387432
PI534072,169.83333333333334,175,54,178,124,12228
PI534072,509.30869521379316,551,2,685,683,779213
PI656069,758.0566232449871,816,2,1010,1008,1062138
PI656069,1110.9637147655365,1143,2,1407,1405,2375342
PI656069,1309.0484367568977,1404,4,1559,1555,3132079
PI576432,664.4160956745148,718,2,798,796,903491
PI576432,378.4715068654606,407,61,493,432,344053
PI576432,1349.1758634687312,1333,44,2153,2109,4079793
PI534075,506.71727696523254,559,4,604,600,655514
PI534075,1237.6235378936763,1373,5,1454,1449,1430898
PI534075,918.837069944171,913,18,1075,1057,2792510
PI533863,948.0852195365858,964,24,1093,1069,2746339
PI533863,1106.1458765118787,1160,96,1309,1213,2778913
PI533863,1079.2928462952764,1150,3,1238,1235,1694812
PI655973,1062.4491478543496,1034,11,1282,1271,3141129
PI655973,971.5080799851017,1004.5,2,1080,1078,2641643
PI655973,1154.7366617364653,1228,2,1297,1295,2622766
PI576358,1138.6105761509075,1220,3,1377,1374,3207164
PI576358,1096.8597681009192,1090,138,1283,1145,2865603
PI576358,1264.3547891874068,1279,53,1401,1348,3394144
PI595713,1060.7526215274709,1104,2,1209,1207,2148447
PI595713,1137.7791362403025,1202.5,3,1290,1287,3019436
PI595713,1424.927721244645,1476,2,1615,1613,3095345
PI656000,1214.0417837343136,1279,2,1362,1360,1766468
PI656000,1031.7882673218562,1084,3,1154,1151,1640082
PI656000,1087.6785598196288,1083,5,1229,1224,2945628
PI534091,175.55220288781933,181,70,184,114,12896
PI534091,173.86575342465756,179,78,182,104,12833
PI534091,169.52054794520546,177,41,179,138,12370
SC0858,811.4775156784492,832,2,942,940,1931617
SC0858,301.8657349652819,324,4,415,411,132708
SC0858,422.7423624526007,435,18,507,489,512575
PI533937,620.8704181600956,626,3,994,991,406818
PI533937,126.34100331674959,135,14,159,145,6983
PI533937,1914.6614009088962,1944,30,2114,2084,5772776
PI533944,1243.7169080386223,1267,3,1383,1380,3329761
PI533944,1243.4977771325332,1263,34,1395,1361,3325417
PI533944,1220.4576549797384,1233,31,1320,1289,3690000
PI656103,1589.9447297896543,1625,653,1799,1146,4850042
PI656103,1151.6278405331216,1145,146,1286,1140,2686524
PI656103,1096.931855500821,1115,32,1238,1206,3347031
PI659694,1471.11817700053,1484,533,1607,1074,4239951
PI659694,1510.845715820575,1538,593,1672,1079,4337770
PI659694,1358.220209490308,1393,22,1475,1453,3889653
PI534160,1354.4611927604471,1349.5,334,1532,1198,4107305
PI534160,959.0678561059173,965,226,1057,831,2923583
PI534160,1394.4775285584064,1415,469,1481,1012,4242652
PI533981,1474.1000281833162,1470,179,2141,1962,4484745
PI533981,1274.6765944567237,1319,474,1377,903,3880727
PI533981,1225.6680509657047,1261.5,376,1348,972,3728530
SC0747,1067.0027777777777,1103,45,1135,1090,3007382
SC0747,1060.4792644757433,1128,569,1190,621,2973907
SC0747,1416.6997582594681,1399,110,1543,1433,4067945
PI595730,1167.523814923272,1181,9,1301,1292,3378761
PI595730,736.446517002311,749,45,936,891,2108109
PI595730,818.1181697066809,880,8,953,945,2482867
PI533937,1427.3481680028333,1413,395,1634,1239,4332671
PI533937,1017.9514705882351,1009,66,1113,1047,2853929
PI533937,1065.01319307112,1058,41,1154,1113,2976251
PI576420,1566.025299339079,1618,81,1725,1644,4508573
PI576420,1301.6535818543491,1312,484,1413,929,3962357
PI576420,1618.2661325796307,1647,173,1774,1601,4936186
PI656114,1483.0304186539481,1493.5,54,1649,1595,4275050
PI656114,1539.4806957953786,1531,376,2618,2242,4646284
PI656114,1324.0628889616771,1389,441,1444,1003,3787368
PI533787,1001.3013363101016,1020,97,1113,1016,3040840
PI533787,867.0729994700582,835,110,1062,952,2323053
PI533787,1243.378715034918,1240,38,1406,1368,3771259
PI576346,1079.594732509489,1082,54,1175,1121,3284291
PI576346,1017.2866088694432,1026,46,1123,1077,3092300
PI576346,920.8654008657113,947,540,1094,554,2797598
PI656009,1387.6739215686273,1417,511,1574,1063,3985265
PI656009,1849.3705736990019,1868,192,1979,1787,5617923
PI656009,2091.1213029275596,2090,484,2216,1732,6108631
PI576437,1156.7731139960551,1177,20,1272,1252,3513827
PI576437,1157.5645726803468,1178,25,1277,1252,3516301
PI576437,848.4321014178081,853,7,920,913,2571799
PI576437,1120.9876081732114,1106,44,1223,1179,3407782
PI534000,1390.4753267973858,1404,466,1526,1060,3997681
PI534000,1382.6449346405227,1398,480,1523,1043,3972270
PI534000,1715.0522875816996,1763,1092,1940,848,5233247
PI534000,1583.3651554165112,1609,103,1758,1655,4829797
PI534065,1061.3260483618226,1090,12,1196,1184,3167274
PI534065,1030.4850116974937,1035,350,1181,831,3139156
PI534065,1213.8838453302942,1219,41,1302,1261,3691432
PI656089,1657.860988952933,1649,482,1846,1364,5041472
PI656089,1117.2116332108922,1133.5,638,1253,615,3391235
PI656089,1114.9683038892124,1132,342,1254,912,3384300
PI656089,1222.754686242313,1259,445,1437,992,3725683
PI656115,1526.0056531870791,1536,56,1696,1640,4644537
PI656115,1266.0446159812118,1299,48,1414,1366,3839626
PI656115,900.469686011433,892,22,1043,1021,2739124
PI656115,902.0222091762032,892,17,1044,1027,2744238
SC0445,1206.541606058843,1207,73,1306,1233,3670344
SC0445,1351.956176222923,1369,50,1484,1434,4103166
SC0445,1376.4776122766275,1384,62,1487,1425,4183394
PI534081,991.8866749988863,1036,2,1172,1170,2471627
PI534081,1081.4977779951419,1134,2,1265,1263,1672157
PI534081,1234.0381191917286,1236,27,1383,1356,3716518
SC1133,916.9798845229791,953,170,1217,1047,2789175
SC1133,842.3916555732139,866,17,937,920,2554136
SC1133,1057.7806382923359,1075,174,1124,950,3210150
PI656008,1810.7486049888314,1907,3,2087,2084,4555999
PI656008,1798.585087440028,1866,3,2037,2034,4082725
PI656008,1910.131710434221,1982,4,2300,2296,4718462
PI576397,1397.917320261438,1393,50,1620,1570,4237382
PI576397,1601.7730392156864,1639,1126,1745,619,4622231
PI533982,565.4306644513185,598.5,2,720,718,754955
PI533982,573.4362810579748,674,8,728,720,195899
PI533982,1450.6350132671698,1523,3,1719,1716,3860661
BTx399,772.0313865801584,795,2,1692,1690,1415039
BTx399,1340.8784638896877,1445,2,1592,1590,2644935
BTx399,1329.3885999116137,1366,6,1411,1405,4023001
PI576366,1235.8362745098038,1260,221,1361,1140,3778808
PI576366,1170.6488435800102,1219,28,1304,1276,3547504
PI576366,1683.7014344470913,1668,463,1887,1424,4887617
SC0759,917.7052826586928,946,2,1152,1150,2360348
SC0759,955.2656208590023,966,77,1150,1073,2427498
SC0759,1343.2859376555502,1383,2,1602,1600,2489868
PI655998,171.6707957957958,178,39,181,142,12517
PI655998,943.8933591323052,1003,2,1103,1101,2066967
PI655998,891.4818420719846,878,28,1026,998,2616875
SC0412,1185.1605447198885,1178,7,1373,1366,3378945
SC0412,721.2875332994026,723,21,795,774,2195052
SC0412,1148.139844576257,1174,5,1323,1318,3337957
PI576335,622.7056075996065,630,6,784,778,1753914
PI576335,830.5373796352421,865,303,945,642,2477313
PI576335,1547.9414767708886,1581,684,1728,1044,4452769
PI576404,306.6633060933447,307,2,483,481,271101
PI576404,995.6317670213421,1059,3,1268,1265,1764953
PI597958,966.2555912223147,965,4,1116,1112,2363269
PI597958,1181.042688597424,1265,3,1411,1408,2709325
PI597958,1111.145855659393,1138,3,1281,1278,2665639
PI656110,1266.79056232751,1328,3,1461,1458,3631628
PI656110,881.9180719485926,910,50,1015,965,2101630
PI656110,944.4854070914482,975,88,1134,1046,2825773
PI656011,1271.4627249675814,1327,6,1422,1416,3471845
PI656011,1703.5858314986624,1737,213,1846,1633,5186040
PI656011,1368.218196325421,1386,228,1470,1242,4144374
SC0479,1067.034045403113,1110,10,1234,1224,3107163
SC0479,1381.0953598470096,1439,3,1513,1510,3940441
SC0479,1300.275687568757,1342,118,1459,1341,3949450
PI152651,785.5289072290043,807,2,868,866,2192489
PI152651,647.5713922487378,698,2,814,812,758116
PI152651,744.9427991045892,782,2,898,896,1754012
PI533812,970.4245497232362,1006,68,1106,1038,2855201
PI533812,733.9381130562643,766,2,846,844,1369753
PI533812,180.3301794052593,203,2,275,273,58653
PI656020,321.84634703196343,362,12,374,362,200869
PI656020,1097.6389434455282,1145,13,1236,1223,2342216
PI656020,657.5528475823598,692,3,843,840,918521
PI597952,1060.2064000998066,1124,3,1384,1381,1470038
PI597952,447.6233368164402,484,2,668,666,383344
PI597952,1059.9357284261146,1137,4,1222,1218,2270116
PI534030,1118.4635672385175,1134,71,1246,1175,2720421
PI534030,1076.2503081052264,1114,6,1269,1263,2483259
PI534030,634.8843414591065,681,2,806,804,699377
PI609456,1121.0755260094904,1136,270,1172,902,3017151
PI609456,481.8471083220424,495,24,519,495,1204798
PI609456,195.3375427845865,196,52,319,267,294116
PI534130,1448.7863812606934,1506,2,1677,1675,2671889
PI534130,943.8847726405387,963,2,1084,1082,2679752
PI534130,1306.2552406601221,1319,11,1563,1552,2485319
PI595705,387.1999279538905,383,51,463,412,834061
PI595705,651.9986300157673,686,3,856,853,703845
PI595705,678.7882429233747,725,2,792,790,1325694
PI533956,484.09894651812454,535,4,608,604,173134
PI533956,282.7542400521853,306,55,377,322,151072
PI533956,541.0067688378033,574,2,654,652,569689
PI656030,579.4694615875719,609,23,693,670,1499371
PI656030,602.8239798220441,580,238,786,548,1570947
PI656030,716.2096120481614,722,122,823,701,2167580
PI656068,1426.1661437246962,1477,2,1561,1559,3573780
PI656068,1384.6900295094288,1412,12,1568,1556,3877991
PI656068,1611.0707155363025,1666,7,1780,1773,3846929
BTx378,1332.6520412024302,1375,2,1465,1463,3219966
BTx378,1311.785051811913,1350,2,1478,1476,2977945
BTx378,1073.351335403365,1145,2,1368,1366,2060152
PI534078,438.389705882353,487,3,586,583,156358
PI534078,771.1511011017834,810,4,919,915,1461036
PI534078,773.470382030317,818,5,920,915,1429701
PI534078,984.4221539028176,1002,30,1077,1047,2863477
PI656096,898.9958823907868,953,12,1110,1098,1060835
PI656096,1249.105034100129,1249,525,1425,900,3790892
PI656096,1428.9631636304398,1509,3,1609,1606,2825851
PI595720,905.4664072065549,964,22,1080,1058,2177655
PI595720,1547.7384027307407,1588,3,1706,1703,4070506
PI595720,1103.9424335529366,1154,7,1253,1246,3024539
PI533961,838.800929098194,867,12,945,933,2544603
PI533961,812.866168909002,800,12,1076,1064,2438044
PI533961,691.1223185418756,663,4,909,905,2008281
PI659693,1465.2390422835801,1520,447,1663,1216,4316543
PI659693,1168.4783243055485,1168,7,1383,1376,3136412
PI659693,1057.3912461159327,1096,98,1190,1092,3049023
SC0618,1274.9385958078183,1306,35,1381,1346,3869232
SC0618,1633.7091503267975,1643,404,1859,1455,4985964
SC0618,1186.1308357215096,1218,276,1341,1065,3606069
PI576434,1661.2168034351032,1667,49,1920,1871,5038652
PI576434,1660.6933047972907,1671,21,1921,1900,5038255
PI576434,1421.0111788683157,1439,261,1592,1331,4322879
PI576434,1886.3996874654276,1925,13,2124,2111,5214174
PI533917,799.0895487953285,811,19,913,894,2319204
PI533917,724.0388574403677,799,2,826,824,973572
PI533917,879.9356205692519,901,2,1023,1021,2568901
PI533780,1307.3107183724132,1319,64,1425,1361,3966049
PI533780,1144.6401960784315,1194,237,1460,1223,3485340
PI533780,1170.3120689478485,1198,7,1357,1350,3467914
PI651496,754.8670009148155,775,4,879,875,2021474
PI651496,827.6928106926669,832,21,882,861,2263452
PI651496,941.3614043459276,928,25,1023,998,2609107
SC0854,956.2556235527622,983,197,1045,848,2905814
SC0854,950.586375558555,992,2,1159,1157,2332592
PI597959,1372.601744374619,1457,3,1664,1661,3334493
PI597959,1691.5712580547847,1752,49,1896,1847,4744942
PI597959,1243.5724344481691,1275,41,1345,1304,3763082
PI597978,434.8925228710485,443,14,473,459,995671
PI597978,809.6950622258036,822,212,976,764,2220497
PI597978,934.6876394321628,946,3,1063,1060,2779684
PI533795,361.65228027650596,363,4,539,535,372186
PI533795,1151.2579436296794,1198,5,1267,1262,1629209
PI533795,170.7042042042042,176,57,179,122,12459
PI533795,170.30105105105105,175,64,179,115,12410
PI533791,625.395746574929,682,2,821,819,1165993
PI533791,625.847989966921,649,2,755,753,1381148
PI533791,786.6783748830812,810,48,930,882,2287318
PI153844,1256.2314208918283,1241,339,1462,1123,3825494
PI153844,1362.1485019090144,1412,597,1516,919,4143770
PI153844,1229.3073275491074,1236,6,1390,1384,3548886
PI533874,944.0708972288182,985,198,1087,889,2868812
PI533874,927.8863402731531,927,3,1052,1049,2770655
PI533874,834.4968388451998,845,19,904,885,2529365
PI655995,1517.0327020422412,1569,19,1748,1729,4600780
PI655995,969.7518899099961,1005,97,1474,1377,2864352
PI655995,1438.3894951745892,1523,196,1748,1552,4377197
PI533887,707.6962698535879,716,179,854,675,2153044
PI534162,1276.1375077681346,1291,315,1513,1198,3891352
PI534162,1090.701919086131,1108,345,1219,874,3318501
PI534162,1391.9274403958616,1402,375,1545,1170,4178448
PI597944,1648.656400088125,1760,42,1888,1846,5005604
PI597944,1744.45953934388,1799,4,1881,1877,5118679
PI597944,1395.2398519895348,1384,30,1602,1572,4158081
PI564164,1274.1617931350038,1299,12,2075,2063,3872922
PI564164,1115.4086444007858,1144,61,1239,1178,3401197
PI564164,1312.933939323761,1325,540,1432,892,4004139
PI576406,1483.9488857218807,1578,4,1739,1735,3796729
PI576406,1095.9231250842822,1101.5,2,1406,1404,2709702
PI576406,1448.5946640877123,1518,4,1594,1590,3542149
SC1442,821.5592236467237,836,12,921,909,1745007
SC1442,916.392521344867,943,3,1017,1014,2317805
SC1442,450.6392298061721,474,54,501,447,542317
PI656112,1301.6908599488538,1362,2,1544,1542,3350235
PI656112,1367.3443670148267,1412,12,1629,1617,3351782
PI656112,1059.2489141773285,1118,3,1216,1213,2420441
PI533867,1332.0401345945734,1440,2,1527,1525,3052367
PI533867,982.3495179283639,1048,2,1126,1124,2372329
PI533867,973.8582125190915,1015,68,1112,1044,2941620
PI533815,1042.7801199483297,1083,18,1253,1235,2995935
PI533815,1068.0686824175218,1102,10,1258,1248,3136253
PI533815,1042.088310990068,1089,2,1233,1231,1994942
PI533815,954.7824107545277,1027,2,1213,1211,1407527
PI576413,1003.4332013299959,1077,2,1220,1218,1600204
PI576413,182.27561327561327,194,32,200,168,14397
PI576413,737.2681321875934,761,3,811,808,1615966
PI656037,1486.2926132067334,1569,2,1631,1629,2868586
PI656037,1120.7014509196774,1177,2,2186,2184,2212386
PI656037,1324.176307051153,1370,2,1511,1509,2241147
PI533894,980.2820608500544,1085,5,1197,1192,1231050
PI533894,170.18918918918916,178,14,181,167,12582
PI533894,682.229054516153,761,3,936,933,1164935
PI576352,380.4213953966649,427,26,520,494,443668
PI576352,169.99524353120245,177,26,178,152,12324
PI576352,169.21556316590562,176,14,178,164,12253
PI533859,1311.385026411915,1354,3,1486,1483,3045453
PI533859,929.3047700870345,976,2,1134,1132,1019548
PI533859,1188.4074640946073,1225,15,1349,1334,3084935
SC1114,877.9014859825138,885.5,39,1076,1037,2613381
SC1114,1028.1608335939795,1013,5,1307,1302,2765348
SC1114,850.8674397156858,883,2,1052,1050,2445180
PI656001,1456.937384453034,1504,5,1568,1563,4401020
PI656001,1292.6426565563647,1373,2,1489,1487,3081554
PI656001,1587.71538030883,1600,119,1715,1596,4802012
PI534032,1663.5883740339002,1705,8,1983,1975,4456933
PI534032,1619.3185143234696,1656,71,1762,1691,4794486
PI534032,1732.5350953676223,1780,2,2001,1999,3857250
PI534002,1054.9182019795076,1085.5,118,1198,1080,3210618
PI534002,1013.5456881050058,1038,311,1151,840,3079182
PI534002,1054.3202865143169,1072,34,1377,1343,2559812
PI656070,1239.8099305071173,1219,141,1411,1270,3763730
PI656070,1285.3471585377147,1321,4,2184,2180,3559909
PI656070,1459.6582815031416,1483,15,1590,1575,4165724
PI533816,1190.6937985214854,1249,5,1372,1367,3554907
PI533816,1534.93163539975,1700,4,1867,1863,2987908
PI533816,962.5072340319588,941,374,1098,724,2902913
PI533992,937.4277020397169,981.5,5,1107,1102,2047466
PI533992,879.6609780111585,888,27,976,949,2665122
PI533992,1165.092350206748,1253,2,1368,1366,2604995
PI533809,1058.397407543579,1055,19,1245,1226,3213385
PI533809,1428.3090402066646,1437,62,1537,1475,4311566
PI533809,1021.1011786737167,1056,140,1250,1110,3104493
PI655970,1261.9664023315418,1376,2,1464,1462,1610252
PI655970,1358.4505766521693,1430,2,1681,1679,2317155
PI655970,1308.2253013046354,1493,3,1692,1689,2374831
PI534049,907.7170683170848,930,212,1134,922,2767634
PI534049,1608.6593168204017,1662,613,1800,1187,4529035
PI534049,1416.0043215425712,1428,89,1498,1409,4293580
PI656082,887.6956801027783,906,5,1038,1033,2604367
PI656082,1410.290598211925,1438,10,1742,1732,2741803
PI656082,869.9761652906777,875,351,1037,686,2651087
PI564163,1110.0512810520545,1105,2,1241,1239,3336961
PI564163,1695.785413393844,1738.5,703,1849,1146,5151822
PI564163,1458.5893817234155,1485,62,1609,1547,4423579
PI576372,1181.7414638853688,1249,12,1349,1337,3466729
PI576372,993.7161232283177,988,67,1228,1161,3021255
PI576372,1374.9674686112785,1412,6,1489,1483,4171472
SC0914,1158.2670839833677,1141,398,1367,969,3520809
SC0914,1212.1944444444443,1221,315,1325,1010,3702136
SC0914,1385.0871437234687,1386.5,269,1559,1290,3840185
SC1082,172.5153903903904,178,51,182,131,12590
SC1082,797.6592936456532,809,41,928,887,2391419
SC1082,975.2177995322797,974,116,1069,953,2940387
PI656029,989.4926866552719,1059,5,1169,1164,1828637
PI656029,1067.007275132275,1090.5,6,1210,1204,3061137
PI656029,371.1749534894791,432,5,565,560,360002
PI533799,1873.3702283063762,1906,751,1980,1229,5687472
PI533799,1952.8416294063186,1993,14,2108,2094,5904162
PI533799,1738.2441176470588,1762,544,1998,1454,5312330
PI656091,1181.2203905826484,1262.5,19,1410,1391,3449235
PI656091,1230.177806898337,1226,458,1488,1030,3740887
PI656091,1512.2709493015423,1499,67,1717,1650,4581856
PI534025,1302.0411764705882,1306,468,1424,956,3977606
PI534025,1488.1297207284606,1542,3,1649,1646,4125310
PI534025,1628.4369427587708,1651,2,1850,1848,4072167
PI534025,1513.494889490884,1524,100,1653,1553,4601340
PI534159,1573.4413683923387,1640,294,1804,1510,4759387
PI534159,1307.049573116086,1300,23,1441,1418,3933232
PI534159,1209.5865955627346,1261,9,1332,1323,3427441
PI533761,1600.6575885700192,1593,27,1816,1789,4793292
PI533761,1034.7656120077609,1061,41,1169,1128,3053898
PI533761,1460.5622067698082,1505,22,1600,1578,4430435
PI576396,372.5036370477206,369,4,655,651,831005
PI576396,476.60984894203716,471,75,612,537,1140320
PI576396,445.26310348111167,445,30,529,499,1079904
PI533977,550.8431558851648,609,2,736,734,914902
PI533977,1248.2005468124194,1333,2,1403,1401,3225376
PI533977,961.3244005939282,995,80,1127,1047,2822509
PI533940,955.3239455080969,988,3,1074,1071,2502682
PI533940,1165.482595592251,1228,3,1309,1306,2764225
PI533940,894.6985268765072,924,6,1041,1035,2426543
PI533773,1093.5303458546305,1100,2,1209,1207,2953338
PI533773,921.9117057940157,972,8,1146,1138,2272596
PI533773,958.4769088663697,967,40,1081,1041,2689753
PI533983,901.9444564117266,913,2,1193,1191,2382737
PI533983,1289.1752769362652,1328,3,1432,1429,3269599
PI533983,1241.275815499544,1266.5,6,1386,1380,3582183
SC0438,970.2487828475126,990,41,1139,1098,2890560
SC0438,1202.8344429369772,1241,390,1335,945,3635538
SC0438,1040.0240770065961,1094,481,1193,712,3166897
PI533786,922.9776338313103,920,359,1096,737,2797871
PI533786,801.8528973600614,809,362,972,610,2431213
PI655999,686.3112712975098,700,63,751,688,1832226
PI655999,727.013703120019,732,65,765,700,1957253
PI655999,889.2644762409468,901,75,970,895,2456841
PI656002,1091.8293974502244,1132,2,1224,1222,2330553
PI656002,1104.9472306767354,1179,3,1248,1245,1825215
PI656002,1207.7548171920457,1211,19,1338,1319,3610098
PI576339,1189.7498645871206,1273,4,1432,1428,1221520
PI576339,1379.2952672258375,1407.5,7,1653,1646,3764878
PI576339,348.0470532547215,352,2,516,514,186324
PI533923,1033.6563965889436,1075,5,1135,1130,1774579
PI533923,991.4694035840955,1059.5,4,1210,1206,1538009
PI533923,829.0545024146546,858.5,2,918,916,1332821
PI534112,1451.6984583408484,1467,342,1573,1231,4422510
PI534112,1511.5942078544722,1522,13,1623,1610,4581552
PI534112,1513.0665170373393,1551,31,1650,1619,4016242
SC0092,1010.2601135916145,1063,31,1145,1114,2602323
SC0092,940.424708914432,957,10,1000,990,2780547
SC0092,953.9787804371888,970,4,1092,1088,2614812
PI595728,1717.3619426659188,1741,202,1853,1651,5218743
PI595728,1320.1092330234633,1343,327,1470,1143,4016506
PI595728,1422.2384754568434,1448,3,1550,1547,4092140
PI534083,1131.4541339133489,1181,2,1281,1279,2624232
PI534083,1113.8629401518317,1132,27,1244,1217,3367129
PI534083,968.333975920436,975,34,1079,1045,2943673
PI534125,967.9325824497034,975,21,1063,1042,2674596
PI534125,1006.2465440706105,1059,9,1175,1166,2644950
PI534125,555.1525093361917,589,2,702,700,909233
SC0556,372.0168357817154,404,68,438,370,160117
SC0556,1210.6387042083566,1307,2,1428,1426,1999323
SC0556,171.00171232876713,176,63,178,115,12398
PI533964,1039.6223102333263,1097,2,1150,1148,1804192
PI533964,1042.2042189903664,1066,133,1138,1005,3145773
PI533964,1089.3408952453287,1134,4,1322,1318,1931974
SC0266,955.1802372034253,941,23,1151,1128,2900556
SC0266,642.4478829460991,672,32,819,787,1868918
SC0266,339.5043083105645,368,4,472,468,254880
PI534091,243.24525188635465,261,28,303,275,129169
PI534091,937.9138910792112,940,25,1134,1109,2824804
PI534091,834.2165464086586,843,59,898,839,2211609
PI656059,1884.7322082469484,2032,2,2167,2165,2767070
PI656059,1501.796952603343,1548,3,1764,1761,3791132
PI656059,1767.5221929231461,1790,65,2061,1996,5227309
PI534094,859.4964521856234,889,2,1045,1043,1121601
PI534094,1106.8591340575988,1115,19,1279,1260,3296979
PI534094,1271.7340150796072,1352,2,1474,1472,3318404
PI534024,710.0348768070885,789,2,904,902,706500
PI534024,1494.5948578441873,1527,36,1732,1696,2952581
PI534024,1317.9094337920492,1333,2,1508,1506,2660665
PI533818,788.0258821667861,797,84,856,772,2378942
PI533818,166.12734109655509,184,2,274,272,121006
PI533818,510.31987932147416,503,5,745,740,959701
PI533962,1098.3926957137267,1110,176,1181,1005,3309550
PI533962,1132.8163197885697,1173,18,1230,1212,3412224
PI533962,1558.3515307934172,1583,126,1675,1549,4736633
PI533993,851.5636118775193,884,2,947,945,2276448
PI533993,882.1064501796213,956,4,1197,1193,859887
PI533993,1275.076314474651,1330,2,1411,1409,3100890
PI533755,857.9534193814211,894,2,971,969,2101478
PI533755,526.4481532147743,588,3,650,647,664882
PI533755,908.7980157388732,938,2,1066,1064,1496770
PI534059,896.8143339442245,937,2,997,995,1837451
PI534059,938.808975338093,992,2,1096,1094,1385992
PI534059,763.6880773209007,799,31,853,822,2184234
PI595748,1358.3507448090859,1399,21,1463,1442,4129644
PI595748,779.0487769598498,782,56,919,863,2357478
PI595748,1150.5904624215277,1191,22,1267,1245,3503752
PI533970,1423.7130427748657,1455,168,1544,1376,4321479
PI533970,1482.5324927265506,1503,52,1683,1631,4513467
PI533970,1773.6936621068237,1795,92,1920,1828,5392848
PI533872,936.3423905502611,961,255,1084,829,2854828
PI533872,779.4964897824653,774,16,905,889,2310926
PI533872,790.9067013148046,807,112,883,771,2405592
PI533842,1291.3147058823529,1296,280,1427,1147,3949015
PI533842,1041.768527569287,1044,182,1196,1014,3172896
PI533842,1573.9432854087759,1586,7,2568,2561,4772740
PI534166,717.0045306467325,737,2,825,823,1763952
PI534166,988.9563254392665,1010,5,1149,1144,2824434
PI534166,1075.7024962856813,1109.5,26,1311,1285,3267583
PI597949,837.7465033210924,837,20,992,972,2525077
PI597949,979.4372698113425,982,38,1082,1044,2963008
PI597949,1097.9121298307016,1104,35,1235,1200,3340504
PI561073,1287.8155365684447,1309,402,1466,1064,3918513
PI655979,1788.6946486603597,1869,2,1986,1984,3370261
PI655979,1387.6627101979132,1432,3,1557,1554,3256360
PI655979,1478.3724148907158,1458,48,1719,1671,4469465
PI597967,1480.003746298167,1513,206,1617,1411,4498704
PI597967,1556.482603631627,1603,38,1708,1670,4603601
PI597967,1461.956889341814,1469,6,1591,1585,3870883
PI655973,1450.4283424408013,1479,34,1652,1618,4418647
PI655973,1091.0528111233236,1090,59,1266,1207,3303355
PI655973,1283.164362066514,1293,32,1451,1419,3901760
PI533969,1297.9009574116872,1317,11,1412,1401,3922868
PI533969,1350.3053325528283,1353,37,1566,1529,4084216
PI533969,1443.9057989223857,1511,273,1615,1342,4346230
PI534049,1749.5717536842235,1785,50,1860,1810,5217759
PI534049,1365.2259247557142,1376,5,1475,1470,4100054
PI534049,1202.4423402684272,1215,20,1281,1261,3373372
PI533981,1706.6840085202155,1750,78,1895,1817,4894236
PI533981,1343.1811851630694,1367,72,1447,1375,4037640
PI533981,1226.92896642528,1237,28,1317,1289,3487271
PI597965,1160.2423580686827,1161,14,1254,1240,3512810
PI597965,1484.0418369634572,1572,185,1911,1726,4431180
PI597965,1274.8155868689,1234,41,1434,1393,3851173
PI533912,961.0166656639191,976,60,1043,983,2660952
PI533912,869.9592321841249,886,7,948,941,2393920
PI533912,1155.3504799202929,1169,54,1268,1214,3255829
PI655975,1268.5801030089453,1277,13,1369,1356,3619858
PI655975,1911.0383550481058,1950,52,2086,2034,5536812
PI655975,1583.6654185885022,1593,622,1760,1138,4766586
PI533950,957.745696913399,966,59,1038,979,2887110
PI533950,1150.879164324197,1155,5,1249,1244,3476381
PI533950,1029.8369437442545,1034,85,1088,1003,3106493
PI576431,1006.8604788461269,1032.5,19,1157,1138,3040156
PI576431,1491.4375376569308,1507,7,1613,1606,4537649
PI576431,1097.532513945353,1102,16,1256,1240,2915256
SC0540,830.0761217011656,851,51,944,893,2212844
SC0540,1156.7859477124184,1169,13,1244,1231,3121969
SC0540,1319.308445793588,1333,46,1488,1442,3964220
PI533993,1048.6179780513949,1055,35,1158,1123,3178727
PI533993,846.2183606001526,810.5,26,1048,1022,2546190
PI533993,983.952066345437,989,90,1103,1013,2959774
SC0834,1378.257458123359,1378,51,1540,1489,4158991
SC0834,1846.6586563035867,1873,11,2016,2005,5541433
SC0834,1755.8150796045816,1801,12,1928,1916,5267750
PI597959,859.5371210531171,861,45,1084,1039,2473087
PI597959,997.5929471679854,1045,23,1112,1089,2697853
PI597959,1374.1113986067014,1383,61,1445,1384,4142475
PI533825,1337.911451571617,1290,4,1681,1677,4039209
PI533825,1269.3144310877208,1297,24,1413,1389,3572115
PI533825,1038.1616871019655,1062,45,1154,1109,3124610
PI534082,1191.1305105670722,1201,45,1389,1344,3548741
PI534082,1270.178733445797,1276,54,1442,1388,3572664
PI534082,1321.1768737493037,1364,389,1564,1175,3960111
PI655999,758.6098492562147,761,43,833,790,2046659
PI655999,762.3684738756285,792,30,838,808,2057037
PI655999,773.6862208678187,797,55,843,788,2097260
PI534129,1795.9252391518603,1809,503,1937,1434,5395320
PI534129,1134.1058904051813,1151,199,1226,1027,3408258
PI534129,1571.7139191170734,1608,9,1767,1758,4779595
PI533985,1656.3370911750897,1664,87,1773,1686,4969396
PI533985,1261.0327655212695,1257,234,1359,1125,3779529
PI533985,1559.6352526087076,1582,39,1683,1644,4688266
PI595717,1973.0081028940037,1947,81,2204,2123,5917874
PI595717,1774.3008041649236,1789,12,1909,1897,5131215
PI595717,1763.9598837524181,1761,62,1983,1921,5337428
PI641874,1294.8702190051245,1303,46,1336,1290,3670596
PI641874,1051.5527087646653,1022,4,1182,1178,2941841
PI641874,1207.3295349795046,1223,71,1321,1250,3435125
PI656091,1928.6378123246423,1976,53,2110,2057,5796486
PI656091,1602.3745407443664,1629,44,1775,1731,4828040
PI656091,1749.465355744665,1751,59,1871,1812,5255311
PI656070,1157.523131126436,1169,395,1252,857,3471621
PI656070,1915.3674169621004,1938,102,2046,1944,5778925
PI656070,1164.339660721735,1191,193,1273,1080,3507115
PI656040,2069.099669312169,2116,24,2222,2198,5865227
PI656040,1729.6771115867423,1771,46,1900,1854,5213302
PI656040,1365.1061226525856,1433,144,1690,1546,4079915
PI533767,796.5928623561109,805,36,899,863,2393843
PI533767,1431.4518281298479,1481,27,1611,1584,4291337
PI533767,1078.0801310991164,1108,15,1180,1165,3234095
PI576393,900.0182071748613,890,89,1102,1013,2711099
PI576393,1344.0673724166159,1368,515,1422,907,4030980
PI576393,1167.8749148932457,1201,77,1283,1206,3350286
PI533899,1146.0329367913287,1153,293,1282,989,3440093
PI533899,1418.827412135855,1489,23,1700,1677,4302418
PI533899,1327.729062589712,1304,61,1544,1483,3986122
PI595728,1741.4379109514089,1717,25,1926,1901,5280814
PI595728,1874.4201198578985,2169,3,2965,2962,5357998
PI595728,1609.9006439515697,1632,580,1749,1169,4915206
PI534120,1309.6405087975677,1324,33,1494,1461,3923384
PI534120,1691.3904926018724,1708,8,1822,1814,5110219
PI534120,1877.1148554521724,1891,20,1996,1976,5654679
PI576400,1163.6896102529045,1191,33,1356,1323,3496822
PI576400,1405.3720513429266,1416,100,1535,1435,4226527
PI576400,1418.8939522190615,1450,28,1551,1523,4064691
PI597943,1770.8565674984384,1792,81,1893,1812,5327597
PI597943,1507.909512260419,1532,60,1634,1574,4536186
PI597943,1656.6777648731986,1676,48,1832,1784,4981606
PI533980,1642.8580755525918,1668,526,1745,1219,4947257
PI533980,1684.9891751663845,1704,51,1761,1710,4764364
PI533980,1636.917643637098,1677,17,1749,1732,4937613
PI655995,1434.4493924330295,1451,55,1554,1499,4025195
PI655995,1738.7181080401883,1778,21,1874,1853,4958945
PI655995,1224.7251243781093,1290,873,1375,502,3403677
PI533852,1489.1811858076562,1605,156,1696,1540,4286088
PI533852,1425.598282127519,1447,38,1530,1492,4067068
PI533852,1472.778074015011,1483,30,1679,1649,4401237
PI597952,1372.2238403006388,1411,140,1514,1374,4142926
PI597952,1161.1112959554484,1176,24,1293,1269,3511022
PI597952,1405.7400497512438,1401,368,1548,1180,4267553
PI576435,1886.6146678527023,1927,14,1993,1979,5464388
PI576435,1647.6799763116423,1665,57,1754,1697,4733173
PI576435,1294.1242424242423,1300,75,1372,1297,3667667
PI595741,1069.49735533693,1086,40,1144,1104,3227154
PI595741,973.124610417223,934,276,1165,889,2919921
PI595741,1078.2825824445101,1073,62,1205,1143,3227360
PI576371,1330.26100370218,1316,20,1476,1456,3753213
PI576371,1391.0579923678742,1394,15,1471,1456,3961123
PI576371,1503.5179084109022,1539,118,1670,1552,4580688
PI534068,1165.3176238870565,1213,3,1446,1443,2410911
PI534068,548.4902563202247,606,2,789,787,686192
PI576335,1184.1686727133406,1199,6,1493,1487,3143638
PI576335,1315.5393069865286,1283,265,1537,1272,3933093
PI576352,844.4981758745237,1041,5,1131,1126,706812
PI576352,821.8340511811317,833,3,1037,1034,1514482
PI576352,1227.3986401008292,1259,13,1471,1458,3145353
PI576352,1002.9312539938355,1112,5,1227,1222,963609
PI597977,1353.1249653743062,1535,6,1876,1870,2930486
PI597977,184.05797101449275,196,46,211,165,51874
PI597977,1103.9375224843313,1163,2,1253,1251,1896833
SC0445,817.4151368534392,895,2,1010,1008,2120110
SC0445,970.8772386193731,1050,2,1178,1176,1196747
SC0445,1375.6858077930078,1419,2,1501,1499,3570030
PI534146,1787.953801084728,1805,103,1965,1862,5341695
PI534146,1782.6136905871729,1805,26,1961,1935,5331536
PI534146,2251.375428755171,2276,112,2434,2322,6766988
BTx645,1679.8631076807515,1711,29,1795,1766,5067224
BTx645,1478.8723930226001,1500,256,1566,1310,4434824
BTx645,1129.9005450229524,1122,6,1231,1225,3397354
PI533790,907.5469321036671,936,60,984,924,2466140
PI533790,1098.9886505736326,1077,267,1285,1018,3313737
PI533790,978.8168289020427,994,8,1045,1037,2946224
PI576411,1122.7596600723527,1113,19,1246,1227,3038954
PI576411,1101.7944861398687,1110,2,1199,1197,2985257
PI576411,1077.406819632381,1132,2,1230,1228,2903360
PI597956,1167.1460256134924,1173,38,1275,1237,3524762
PI597956,1215.6716557650002,1224,6,1332,1326,3687147
PI597956,1061.6776419945395,1038,98,1341,1243,3149917
PI533846,1073.9149422360974,1094,2,1272,1270,2862171
PI533846,880.1668239835669,903,2,969,967,1918694
PI533846,1144.4865798819455,1148,145,1242,1097,3434076
SC0479,1347.4124904455064,1357,2,1504,1502,3653996
SC0479,1334.8089298770356,1369,67,1471,1404,3803040
SC0479,1680.0606745659259,1707,1018,1857,839,4840210
PI533859,1110.6339422310434,1111,16,1193,1177,3000470
PI533859,1447.40103711052,1458,7,1644,1637,4329064
PI533859,1682.901596295712,1695,9,1903,1894,4507066
PI595718,1313.7533019223051,1335,56,1488,1432,3934674
PI595718,957.4555860766792,997,2,1123,1121,2390299
PI595718,1297.2529954196839,1301,50,1435,1385,3910639
PI534134,1715.8478464609907,1729,3,1845,1842,4926705
PI534134,1003.6661052031508,1026,2,1148,1146,2246850
PI533934,1883.7058091222739,1894,15,2107,2092,5328901
PI533934,1593.2332062720634,1716,37,1979,1942,4407353
PI533934,1598.8230726761162,1715,2,1999,1997,4462435
PI533934,1323.9205905757558,1342,5,1403,1398,3986756
PI534053,1103.141183068497,1089,121,1244,1123,3184860
PI534053,1163.239636695519,1228,6,1374,1368,2931132
PI534053,1119.4408739827293,1132,3,1323,1320,2834486
PI533753,1085.804463520104,1102,9,1177,1168,3275622
PI533753,883.7898142089655,931,2,996,994,1641540
PI533753,1073.2240690876797,1099.5,2,1265,1263,3084448
PI534073,1538.7938728221789,1575,15,1797,1782,4483111
PI534073,1664.014105514183,1767,2,1903,1901,3715816
PI533745,1019.6681706829035,1014,2,1365,1363,2542114
PI533745,753.5385704175512,776,4,885,881,2120725
PI533745,787.529828332021,866,3,939,936,1313720
PI533778,545.4319783971854,585,8,609,601,695007
PI533778,800.8016781083143,874,2,952,950,894453
PI533778,983.9789047006902,1023,2,1096,1094,1722513
PI533961,1211.6608544532478,1276,26,1374,1348,3239530
PI533961,851.9789501780997,917,2,989,987,2395665
PI533961,968.9457254223948,962,165,1198,1033,2722519
PI656076,1106.1229624088865,1140.5,2,1286,1284,2607484
PI656076,1119.8579728744635,1158,3,1283,1280,2597812
PI656076,1275.3303960891822,1292,2,1423,1421,3261429
PI656076,1575.036238144306,1607,27,1804,1777,4246936
PI595739,1539.178634861294,1687,4,1865,1861,3938798
PI595739,1446.4590241432666,1600,10,2037,2027,3150835
PI656009,1356.7483880715677,1458.5,7,1707,1700,3092388
PI656009,1591.6924423560306,1762,11,1960,1949,2257219
PI656009,1622.3120693141523,1730,4,1799,1795,2630375
PI656108,295.00573770491803,311.5,3,379,376,136420
PI656108,114.70653377630123,112,2,182,180,137064
PI534024,1592.6596766115963,1600,3,1813,1810,4808807
PI534024,1585.2794960078195,1624,58,1749,1691,4777649
PI534092,932.0063040985478,971,47,2093,2046,2823568
PI534092,842.0741429938835,904,2,1127,1125,1800141
PI533862,418.05670357571057,432,55,451,396,874758
PI533862,383.8431858887381,396,53,435,382,830180
PI533862,375.3777088711512,383,74,416,342,897681
PI533830,933.0848357367379,992.5,2,1111,1109,1745836
PI533830,896.0695224084147,934,2,1054,1052,1814245
PI533830,1106.5519647696476,1132,53,1455,1402,2975730
PI607931,964.4218674630112,983,2,1058,1056,2715468
PI607931,1062.7617586257632,1122,2,1241,1239,2659978
PI656115,210.56994254012284,226.5,7,242,235,56494
PI656115,1132.6356073544837,1172,14,1369,1355,3411597
PI656115,1150.4932773029118,1220.5,189,1297,1108,2505299
PI595744,1393.292771589412,1420,70,1720,1650,2878329
PI597980,333.73074761101736,358,2,429,427,366102
PI597980,933.5272707168992,979.5,5,1257,1252,1532922
PI533865,861.708614882612,954,2,1031,1029,1723321
PI533865,1269.5005457475643,1312,97,1509,1412,3471974
PI533865,837.6526394551472,829,183,1028,845,2544676
PI576397,1380.3212569039433,1393,3,1504,1501,3244469
PI576397,1774.7117394151646,1810,17,1924,1907,5165902
PI576397,1273.6652865465385,1293,92,2292,2200,3794388
SC1058,1254.3828660230854,1254,15,1390,1375,3778684
SC1058,1538.5793685025515,1574,57,1670,1613,4592599
SC1058,1062.2068169707527,1068,251,1281,1030,3193282
PI533804,771.9302468371759,807,14,918,904,2343134
PI533811,1626.0225490196078,1644,410,1802,1392,4712540
PI533811,625.5566891367856,701,4,808,804,1859984
PI533811,1792.7160130718958,1725.5,50,2107,2057,5224420
PI576345,1417.4564099904078,1439,85,1550,1465,4313381
PI576345,1162.6634804756309,1197,4,1295,1291,3491499
PI576130,2064.190633090139,2119,57,2229,2172,6005703
PI576130,1384.1719836000616,1398,189,1643,1454,4149835
PI576130,1485.4153266062897,1505,3,1679,1676,4491499
SC0868,1201.0086960039876,1199,208,1315,1107,3655824
SC0868,1562.701060836896,1585,103,1693,1590,4708335
SC0868,1416.6268925417485,1445,25,1515,1490,4292327
PI533977,1420.3680500051437,1454,13,1688,1675,4294988
PI533977,1465.3466989061876,1493,8,1577,1569,4441581
PI533977,1664.2943655359275,1720,22,1825,1803,5041725
SC0551,873.6210955644136,930,40,1110,1070,2652916
SC0551,811.4206454490798,817,15,981,966,2468738
SC0551,732.7648223653262,760,40,950,910,2180713
PI576436,1178.136036838978,1200,178,1278,1100,3364059
PI576436,1187.8289630247702,1227,166,1337,1171,3346514
PI576436,1514.3825720330146,1482,59,1772,1713,4371166
PI533775,1482.470200856108,1507,5,1638,1633,4489278
PI533775,943.5913337538999,944,32,1155,1123,2879896
PI533775,955.9113609959045,1003,62,1158,1096,2902563
PI595748,916.1849189380056,940,29,1103,1074,2780735
PI595748,1031.3755004889094,1066,129,1238,1109,3145979
PI595748,1304.395751633987,1340,569,1476,907,3980193
PI22326,979.0415270892581,1000,23,1189,1166,2941059
PI22326,1133.192713748987,1190,102,1423,1321,3034169
PI22326,1502.881152085879,1480.5,11,1716,1705,3948878
SC0412,800.683434797782,824.5,49,915,866,2438970
SC0412,796.5682965562241,791,27,933,906,2426952
SC0412,1111.2145448393426,1149,59,1301,1242,3389161
PI533760,1583.8713348946137,1561,14,1742,1728,4574436
PI533760,1598.8784679165663,1665,17,1781,1764,4620324
PI533760,1170.2521138151606,1116,37,1629,1592,3323403
PI533757,1293.2155035128806,1277,55,1435,1380,3694635
PI533757,2016.9402662424045,1975,10,2259,2249,5874548
PI533757,1557.2712418300655,1577,219,1710,1491,4526714
PI656011,1343.8493464052287,1402,368,1500,1132,3862590
PI656011,1240.0512510568935,1292,19,1444,1425,3751310
PI656011,1209.1802514853448,1249,392,1351,959,3668494
PI656022,858.8321964204629,869,31,935,904,2592159
PI534064,716.3856295313881,721,26,823,797,2151843
PI534064,609.0588439124874,638,2,807,805,1362317
PI534064,1103.4602459726314,1105,13,1253,1240,3080383
PI561072,852.0912844036696,877,28,912,884,2362579
PI561072,1105.6678761309581,1105.5,27,1173,1146,3098169
PI561072,1124.9633923634185,1156,38,1216,1178,3170487
PI533853,1282.0389813452143,1289,27,1519,1492,3846267
PI533853,1235.3591633491883,1283,25,1484,1459,3756853
PI533853,1114.545037846584,1134,78,1347,1269,3375887
PI34911,1117.1190396376442,1089,31,1395,1364,3346759
PI34911,1611.813221139767,1668,76,1767,1691,4611428
PI34911,1605.5054167836095,1659,56,1717,1661,4650560
SC0848,730.9298589611283,762,224,886,662,2186030
SC0848,908.4388196811219,927,29,1056,1027,2530125
SC0848,654.1133520074696,660,536,704,168,1752579
PI656096,929.4353183061621,937,37,1024,987,2805312
PI656096,1570.2141804326902,1642,21,1739,1718,4684177
PI656096,1321.6340149170142,1340,136,1507,1371,3964640
PI656110,1157.3536549626542,1205,215,1286,1071,3470655
PI656110,1232.8294445376116,1254,27,1320,1293,3719449
PI656110,883.9723643640549,891,149,1020,871,2686412
PI655998,741.8666658242244,745,37,923,886,2104145
PI655998,620.0599606251154,679,2,821,819,745683
PI533785,1168.3961334527414,1173,162,1353,1191,3328746
PI533785,1440.016448787062,1464,4,1654,1650,4035366
PI533785,858.5520617572,854,13,969,956,2600482
SC1082,784.4305785007577,791,5,948,943,2126973
SC1082,1098.995260208762,1112,10,1211,1201,3087884
SC1082,696.4505576221898,710,6,802,796,1838237
PI595747,1149.5786790620787,1146,10,1298,1288,3492025
PI595747,1470.596162363106,1506,258,1610,1352,4465796
PI595747,1173.2293011867566,1152,36,1373,1337,3569684
PI595726,1236.3614346978557,1270,2,1377,1375,3104768
PI595726,1463.9300493312676,1493,13,1619,1606,4340199
PI595726,1259.6107882041706,1264,414,1412,998,3827229
SC0236,1044.2942627943992,1078,2,1189,1187,2757811
SC0236,990.1679897451754,1000,422,1081,659,3018144
SC0236,798.7720423110645,846,2,1019,1017,1769743
SC0236,857.3762249659992,878,8,1035,1027,2043657
PI533957,961.4120225282518,975,54,1051,997,2927019
PI533957,907.7963393388519,926,14,1013,999,2751013
PI533957,1290.8008070888727,1317,641,1416,775,3913408
PI534046,1450.6852728409099,1465,54,1598,1544,4270726
PI534046,1315.8561987955013,1394,2,1512,1510,3735984
PI534046,1205.7795485042814,1257,9,1338,1329,3071793
PI533889,696.1274901892277,689,19,892,873,2103956
PI533889,934.4568324481448,950.5,39,1071,1032,2839705
PI533889,984.342189771696,1013,3,1144,1141,2895976
PI533900,1140.4819316470466,1182,8,1238,1230,3349682
PI533900,1326.3449685206378,1381,10,1509,1499,3737566
PI533900,1145.8234975645896,1174,14,1308,1294,3392624
SC0823,1377.5463731630439,1422,249,1499,1250,4038654
SC0823,1128.808568863221,1170,13,1305,1292,3356650
SC0823,992.1604240787151,998,121,1127,1006,2790689
SC1216,830.3752675839056,802,34,1033,999,2508774
SC1216,1013.7656154845718,1024,187,1192,1005,3080639
SC1216,889.8744639270398,891,2,1086,1084,2364168
PI565121,1648.2444444444445,1644.5,185,1830,1645,5024345
PI565121,1477.6424242424243,1507,541,1648,1107,4491369
PI565121,1748.7977673358594,1804,444,1898,1454,5295177
PI534072,1325.673285767834,1346,98,1452,1354,4030749
PI534072,775.4342916227307,780,107,856,749,2358915
PI534072,1465.5221210706504,1488.5,148,1692,1544,4447691
PI656069,1786.4893499430345,1831,26,1944,1918,5394812
PI656069,1752.8064751934514,1752,86,1931,1845,5307535
PI656069,1605.9126312697363,1625,142,1775,1633,4879324
PI576432,1296.7839869281047,1292,599,1474,875,3951985
PI576432,1265.5526143790848,1283,374,1423,1049,3866561
PI576432,1232.4653205445836,1224,543,1409,866,3754785
SC0505,1548.2388652454706,1516,38,1884,1846,4622635
SC0505,1494.8707184351792,1510,603,1666,1063,4519767
SC0505,1485.5921099457537,1462,29,1758,1729,4505714
PI534075,1338.7446824006456,1349,59,1485,1426,4035354
PI534075,726.5395269014106,709,99,903,804,2215627
PI534075,1113.88081103111,1096,368,1275,907,3375161
PI533863,1171.9124633279816,1218,361,1392,1031,3551469
PI533863,1258.8708675649032,1293.5,185,1440,1255,3807136
PI533863,937.1545022638171,949,6,1143,1137,2837240
PI655973,1169.6643743301852,1174,81,1258,1177,3537890
PI655973,1134.8796720660932,1145,148,1259,1111,3440319
PI655973,1031.4831832997052,1054,703,1196,493,3137305
PI595713,1798.1072322103917,1798,423,1998,1575,5451419
PI595713,1469.0980941155108,1465,47,1630,1583,4371920
PI595713,1576.0737667289138,1595,49,1658,1609,4766718
PI656000,1250.8259541412194,1248,132,1485,1353,3808679
PI656000,1537.4104575163399,1568,639,1678,1039,4693139
PI656000,1727.205882352941,1719,486,1935,1449,5276238
SC0858,871.0897685472763,880,83,988,905,2648357
SC0858,1382.1094868150444,1398,21,1547,1526,4204713
SC0858,1625.9596825750987,1631,6,1787,1781,4919137
PI533937,1664.4109555189457,1633,146,1854,1708,5065697
PI533937,1389.4156750566362,1394,32,1520,1488,4169022
PI533937,1533.125307922947,1569,576,1694,1118,4662893
PI576411,1149.0481459024002,1155,397,1291,894,3462922
PI576411,1279.3309647161025,1287,36,1392,1356,3829318
PI576411,1287.5479070716494,1312,19,1380,1361,3657631
PI655987,2066.8867924528304,2151,3,2242,2239,5987109
PI655987,1784.093690457288,1837,49,1954,1905,5116291
PI655987,1893.0593729427253,1890,32,2184,2152,5668599
PI533938,1539.3668304795156,1554,55,1655,1600,4627222
PI533938,1518.2907924300148,1528.5,31,1724,1693,4559780
PI533938,1558.4935791899902,1623,548,1754,1206,4712122
PI533825,1067.8927937418011,1081,9,1158,1149,3226456
PI533825,1123.3749099605266,1132,61,1221,1160,3146662
PI533825,1278.2401915645355,1278,398,1497,1099,3844558
SC1107,1107.3849579275789,1129.5,8,1214,1206,3079360
SC1107,1370.303049217616,1385,15,1624,1609,4113526
SC1107,1392.9891757939017,1403,29,1577,1548,4190567
PI576340,1503.4915527695998,1508.5,39,1554,1515,4294144
PI576340,1366.8422210223362,1378,14,1436,1422,3885786
PI576340,1714.5851600427322,1650,72,2030,1958,4942936
PI533757,2224.8158709106983,2264,9,2349,2340,6460135
PI533757,2047.0236882099643,2078,88,2254,2166,5928274
PI533810,2032.0495488825713,2037.5,54,2202,2148,5897523
PI533810,1856.7447223108816,1856,16,1999,1983,5548896
PI533810,1145.8546910643608,1152,27,1233,1206,3218446
PI656083,1625.5887818921958,1631,10,1779,1769,4880696
PI656083,1676.8370020350085,1677,38,1831,1793,5023124
PI656083,1702.848734932617,1705,453,1833,1380,5106695
PI533861,1621.1238758576847,1690,28,1799,1771,4879039
PI533861,1135.4268663906464,1126.5,465,1366,901,3432647
PI533861,1959.318594998884,2036,112,2135,2023,5849429
SC0470,1401.0448498883918,1440,14,1575,1561,3937918
SC0470,1391.967320261438,1416,613,1513,900,4235504
SC0470,1605.0394892745194,1606,22,1792,1770,4839901
PI576392,1785.1190890069743,1821,48,1994,1946,5350877
PI576392,1098.151951359296,1102,60,1205,1145,3299129
PI576392,929.2767886658796,939,7,1021,1014,2566976
PI595711,1187.3572395348428,1205,13,1288,1275,3581277
PI595711,1402.8797885580148,1477,130,1634,1504,4278343
PI595711,1250.0211255167026,1299,27,1387,1360,3791700
PI533889,1016.3423794323932,1051,200,1153,953,3085907
PI533889,1343.2764082046235,1366,124,1464,1340,4036627
PI533889,825.9716045898435,827,11,907,896,2485418
PI534062,1049.1140843668495,1059,25,1151,1126,3156864
PI534062,1234.1217793851004,1245,111,1331,1220,3449093
PI534062,2038.631511671294,2110,4,2301,2297,4545255
PI641874,812.7157403551746,827,4,986,982,2185817
PI641874,1033.976160990712,1062,33,1143,1110,2901463
PI641874,944.6876971458295,948,41,1066,1025,2628906
PI576424,2206.2561806099993,2266,18,2471,2453,6559473
PI576424,1625.9015969290335,1594,5,1849,1844,4889297
PI576424,1242.9304711637578,1241,265,1377,1112,3631867
PI656095,1381.3478277641161,1439,8,1578,1570,2713826
PI656095,951.4752350434302,1010,3,1153,1150,1385956
PI656095,587.6371267801716,617,2,689,687,826254
SC0159,972.698479254571,994,3,1171,1168,2629062
SC0159,134.05532467532467,146,2,200,198,21788
SC0652,450.09070501518056,486,2,592,590,275176
PI655976,153.92068901989683,180,4,207,203,23366
PI534105,879.3793882105815,920,2,986,984,2044905
PI534105,1276.6037381311594,1286,5,1384,1379,3803710
PI534105,1424.7163171679263,1527,15,1634,1619,3987055
PI534097,875.4998434386016,907,2,984,982,2105682
PI534097,1307.0581671121176,1337,155,1500,1345,3932089
PI534097,910.3084851441747,956,2,1035,1033,2614326
PI533777,1137.2638000549368,1141,6,1282,1276,3181826
PI533777,1207.9720376813912,1323,14,1375,1361,1080772
PI533877,274.37222610518955,303.5,9,376,367,100177
PI533877,1059.254369646702,1093,2,1190,1188,2375289
PI533877,849.5505051894077,875,2,940,938,2159236
SC1170,469.4907979290787,475,2,610,608,512623
SC1170,532.7629525283388,562,3,653,650,971200
SC1170,1152.273559351499,1325,7,1439,1432,2862156
PI534124,1253.1049682181738,1290.5,3,1415,1412,3400169
PI534124,1305.7641199343318,1322,91,1483,1392,3906588
PI534124,1302.7500527530096,1280,265,1457,1192,3929397
PI597961,1433.029805080621,1470.5,5,1559,1554,4074124
PI597961,1224.062784715756,1249,65,1370,1305,3646977
PI597961,1368.316456895142,1352,46,1565,1519,4053731
PI533920,897.5378406414347,910,78,986,908,2695990
PI533920,1532.5535719875338,1554,7,1685,1678,4631163
PI533920,1068.983115718173,1041.5,651,1438,787,3255789
PI533848,173.12605961170357,174,46,252,206,61669
PI534107,334.07579787234044,371,4,426,422,169825
PI533958,1116.95160772744,1143,53,1287,1234,3090608
PI533958,997.3242095166581,1012,45,1205,1160,2982984
PI533958,1187.9158556536302,1210,45,1430,1385,3083218
PI533751,1124.9667552223352,1211,5,1311,1306,2775014
PI533751,1611.213471986879,1664,16,1750,1734,3870331
PI533751,1850.6053726549383,1911,23,2086,2063,5460709
PI534110,1172.95470059246,1120,3,1858,1855,2173581
PI534110,1466.2649403145565,1512,5,1836,1831,2275688
PI534110,1683.3220577298132,1771,2,1895,1893,3895785
SC0860,1439.2515846262104,1514,2,1735,1733,2635614
SC0860,1435.1112237267407,1478,3,1643,1640,3005490
SC0860,1411.0039204756595,1477,2,1594,1592,2887175
SC0456,512.1038260731991,559,8,640,632,393754
SC0456,147.94892473118279,160,2,185,183,54970
PI576383,1012.2451786688395,1050.5,33,1157,1124,2691506
PI576383,737.4484642922773,776,2,886,884,1897576
PI576383,767.245502337207,824,5,890,885,1886989
PI576417,916.4992114711536,925,68,1081,1013,2507540
PI576417,876.3548864318534,894,5,1092,1087,1893846
PI576417,895.9291462830432,991.5,3,1095,1092,1721338
PI576364,1205.7529392861695,1277,9,1481,1472,2680066
PI576364,1196.8278741134077,1236.5,4,1487,1483,2411875
PI576364,1238.6881811743776,1273,2,1436,1434,2612360
PI656060,954.10169998411925,1011,8,1096,1088,2124803
PI656060,854.9882486487538,847,194,927,733,2569584
PI656060,983.8352321424303,1004,2,1150,1148,2287739
PI533763,255.6947338777809,264,57,364,307,274564
PI533763,771.8153991300375,838,5,896,891,1225252
PI533763,616.3781259083257,668,3,853,850,1091536
PI534164,151.53241561511453,158,3,226,223,36014
PI534164,407.3235104891892,443,2,532,530,176406
PI576419,840.3178311750628,880,2,1055,1053,2056913
PI576419,408.17362980029196,425,8,473,465,930194
PI576419,728.6387534826272,743,7,855,848,1894350
PI534046,1092.0430768238384,1157,6,1316,1310,2664338
PI534046,1175.775691229816,1195,21,1340,1319,3424878
PI534046,1159.3350873995146,1113,2,1510,1508,2758195
PI534038,2077.2805069848077,2146,4,2314,2310,4552923
PI534038,1686.0186648066674,1851,16,1942,1926,3454676
PI534038,1689.1164918625677,1937,2,2175,2173,2053770
PI533903,504.06275552505934,565,2,640,638,342624
PI533903,1264.8573854333017,1309,2,1474,1472,1471187
PI533903,1228.9460568235431,1413,3,1492,1489,1110289
PI533814,1172.3953649054195,1228,7,1382,1375,2831357
PI533814,1345.9301448484393,1430,56,1522,1466,2850511
PI533814,1306.2904359911563,1382,3,1496,1493,2778752
PI533904,1203.094404486349,1238,24,1351,1327,3273328
PI533904,1510.1628094092434,1517,183,1778,1595,4518132
PI533904,1176.1093583874613,1211,3,1346,1343,2460981
PI595732,1690.7011711195473,1731,11,1915,1904,5126207
PI595732,2037.544359243046,2075.5,39,2281,2242,6163312
PI595732,1508.5407452302113,1541.5,3,1653,1650,4041262
PI534167,1209.7856514637517,1222,3,1476,1473,2642549
PI534167,1311.9891673169232,1407,3,1578,1575,3030465
PI534167,1433.6311912520323,1490.5,492,1718,1226,3513625
PI534037,943.2173925221865,943,7,1092,1085,2605061
PI534037,1060.9799997138807,1070,28,1167,1139,3192809
PI534037,1003.685264089221,965,39,1181,1142,2728417
PI534150,1281.247435736597,1326,24,1567,1543,3326833
PI534150,1130.7877425162433,1088,27,1341,1314,3421974
PI534150,1054.1087980687396,1049,6,1206,1200,3147145
PI533841,1049.5815346532781,1064,29,1134,1105,2985871
PI533841,904.3594476146679,915,225,1145,920,2709692
PI533841,1393.9272754649378,1403,24,1489,1465,4200195
PI534055,782.9547275194508,775,21,998,977,2068401
PI534055,1397.7340034845495,1399,20,1583,1563,4012883
PI534055,1326.0404142939344,1377,4,1526,1522,3224888
PI595737,1530.2937830392327,1516,15,1695,1680,4596498
PI595737,1842.633394060827,1812,21,2995,2974,5357403
PI595737,1522.2036998630724,1557,29,1668,1639,4612028
PI595704,1542.5297718780175,1556.5,73,1697,1624,4620788
PI595704,1653.6083036395305,1687,61,1829,1768,4983443
PI595704,1395.5900933791063,1474,134,1648,1514,4215527
PI659695,76.27254901960785,80.5,7,94,87,15595
SC0893,1216.6782302132438,1305,2,1488,1486,2053973
SC0893,1570.3953504530732,1696,3,1799,1796,4079594
SC0893,1467.8323486980794,1482,6,1532,1526,4383430
PI656051,1943.2423014631654,2024,5,2175,2170,4892457
PI656051,1809.5577128844106,1847,2,2114,2112,5233144
PI533876,125.92800921736291,131,3,213,210,86915
PI533876,252.32257323000132,291,4,360,356,43517
PI533884,799.2709071395329,840,11,996,985,930314
PI533884,982.0819201589863,987,3,1147,1144,2607486
PI533884,810.9668208106443,847,2,995,993,2077993
PI576391,1458.937500966002,1463,146,1635,1489,4236497
PI576391,1119.2891509484011,1142,2,1239,1237,2778054
PI576391,1370.4343280823,1427,3,1584,1581,3705293
PI533817,817.9648847499486,887,2,1097,1095,907444
PI533817,1269.0886950690274,1279,328,1413,1085,3741372
PI533817,1290.165025915599,1354.5,3,1452,1449,2195349
PI534153,1379.556733268356,1449.5,2,1612,1610,2054271
PI534153,1458.5300986582479,1551,2,1616,1614,2019151
PI534153,1186.5993532134737,1245,9,1340,1331,2413238
PI533900,1008.044560034022,1019,2,1117,1115,2492368
PI533900,992.5608246936465,1045,7,1137,1130,1730512
PI533900,1044.9985753334313,1079,2,1253,1251,2204894
PI533900,1020.8202636275652,1049,2,1250,1248,2107635
PI533915,469.17924528301893,495,2,736,734,399995
PI533915,1413.4907856478435,1474,3,1716,1713,2824324
PI533915,1566.048187291658,1651,7,1873,1866,4719057
PI597953,527.8681663537764,575,2,625,623,531177
PI597953,321.95397365258606,316,2,480,478,239484
PI597953,811.2071591463375,859,2,951,949,1611154
PI533783,468.95156530820424,530,3,609,606,287538
PI533783,167.30777591973245,190,3,229,226,31537
PI533783,892.6393386729421,898,6,1045,1039,2567693
PI534158,1131.8087557371414,1164,3,1258,1255,2732455
PI534158,1120.8095507029968,1169,2,1246,1244,1904626
PI534158,989.7983816242788,1000,2,1230,1228,1547918
PI534158,1462.216519559226,1588,3,1640,1637,1768150
SC0157,1033.53579943817,1095,3,1222,1219,2483129
SC0157,1062.6187677343632,1110,4,1375,1371,2527690
SC0157,1214.978395165634,1245,2,1312,1310,3055250
PI534048,747.031376064545,752,7,940,933,1430334
PI534048,1097.975298489949,1162,2,1302,1300,1734297
SC0297,501.7258134510057,534,5,658,653,661556
PI534071,62.19401000206035,67,3,90,87,14944
PI534071,65.70615079365079,70.5,2,98,96,18696
PI533789,1896.2923499593699,1941,33,2029,1996,5666501
PI533789,86.2697682287261,90.5,2,132,130,20852
PI534009,1226.258094766089,1316,2,1454,1452,1335550
PI534003,979.2726083552905,1046,7,1102,1095,1147802
PI534003,1239.8292256481575,1347,2,1626,1624,2511990
PI534003,1289.4301782739426,1384,2,1541,1539,1623235
SC0753,462.54660647165133,531,9,606,597,183283
SC0753,324.9859047841852,368,7,473,466,130458
PI533888,71.91300434184052,80,2,88,86,9578
PI533888,393.6416148913342,466,3,552,549,214211
PI533888,293.6948818084139,333.5,2,392,390,208519
PI656099,952.4974096014344,1026,2,1168,1166,1039239
PI656099,738.2589157659427,823.5,3,942,939,970777
PI533767,488.25719254931795,519,3,617,614,660834
PI533767,1208.4831302102184,1280,2,1365,1363,1525698
PI533767,625.568554106164,675,3,822,819,677461
PI533893,1178.35281507752,1250,3,1367,1364,2115708
PI533893,804.1844631661442,844,2,894,892,1673135
PI656039,616.8484454119539,695,2,755,753,431631
PI656039,234.26243526049478,255,3,326,323,106114
PI656039,668.4587603801585,674,5,942,937,879434
PI534118,1254.3632374548624,1371,9,1552,1543,2422980
PI534118,1252.4210210404335,1280,2,1447,1445,2746175
PI534118,1649.2883793603883,1685,4,1960,1956,4510164
PI656040,988.5170119910774,1089,2,1254,1252,1592632
PI656040,825.2234343434343,902,2,1114,1112,2214485
PI656040,1120.985328603042,1188,2,1317,1315,2050561
PI534147,784.5100092544392,792,23,934,911,2395398
PI533771,399.253300850712,409,48,487,439,964271
PI533771,874.9775948080712,900,46,1022,976,2655526
PI533771,998.6443528957578,1029,11,1096,1085,2916115
PI656027,1753.2031362793873,1817,563,1947,1384,5116967
PI656027,1584.5942019290064,1585,13,1897,1884,4674126
PI656027,1432.6287581699346,1466,260,1686,1426,4137830
PI534136,984.9233569313885,1030,12,1128,1116,2970314
PI534136,1200.9505385126495,1237,28,1296,1268,3625460
PI534136,1603.6645204259075,1583.5,182,1844,1662,4884967
SC0150,1452.672323686671,1530,191,1604,1413,4390153
SC0150,966.401212989309,975,310,1064,754,2943077
SC0150,826.1065497555551,838,35,1049,1014,2503022
SC1119,957.617495854063,974,49,1042,993,2545768
SC1119,1066.1721077429647,1091,3,1225,1222,2900684
SC1119,1281.6878862882108,1321,33,1408,1375,3851874
PI534039,1054.459328858149,1095,2,1255,1253,3110044
PI534039,865.9819221195817,891,65,1025,960,2599567
PI534039,979.2449025467697,944,7,1284,1277,2675743
PI576426,1494.9962986336825,1553,8,1668,1660,3550382
PI576426,832.070400954216,853,2,968,966,1578831
PI576426,1042.3276165914463,1113,2,1255,1253,1145850
PI534070,171.59572072072072,178,8,181,173,12513
PI534070,507.6758859753787,578,2,615,613,277484
PI534070,436.44916739702023,479,3,585,582,297578
PI595724,1210.3182145295614,1288,3,1396,1393,2829821
PI595724,381.4708933571353,403,3,481,478,239402
PI595724,658.5578998442428,655,2,938,936,779788
PI533758,259.5274437030859,277,3,402,399,299719
PI533758,961.2129806801827,1047,2,1161,1159,1146149
PI533758,1132.2258584255214,1187,2,1292,1290,2257445
PI534104,1328.1743275385663,1336.5,5,1646,1641,3746509
PI534104,1534.3802996124705,1546,33,1673,1640,4442237
PI534104,720.9746695574163,768,2,868,866,1307311
PI595739,1141.6349167144854,1163,9,1346,1337,3106779
PI595739,1365.1636285449988,1410,409,1521,1112,4137021
PI595739,1513.5124089635856,1520,579,1722,1143,4517154
PI533960,920.8469264556861,961,13,1081,1068,2796360
PI533960,1073.6082290313225,1087,10,1251,1241,3163593
PI533960,976.5749888291509,1030,2,1149,1147,1783662
PI576400,1286.8391254605617,1284,14,1458,1444,3773249
PI576400,1100.9435880211072,1098,104,1235,1131,3345543
PI576400,1386.032570504176,1371,42,1552,1510,4138981
SC1023,773.3514750894427,836,2,968,966,1343587
SC1023,337.2017402309761,366,2,482,480,310891
SC1023,591.0238981562775,638,8,699,691,599901
PI533987,761.2685473825978,816,4,957,953,1839915
PI533987,606.024778432788,653,5,753,748,689420
PI533987,512.118220610145,532,2,669,667,491791
PI533913,1037.2667290253398,1120,3,1241,1238,1151575
PI533913,1043.5641594342655,1070,168,1191,1023,2912564
PI533913,607.6764171524372,647,2,715,713,1081148
PI533828,1121.548728942054,1137,8,1269,1261,3389372
PI533828,1188.8928184413414,1236,366,1397,1031,3611183
PI533828,1218.8512185302257,1203,23,1495,1472,3651573
SC0287,636.3935788729907,642,61,687,626,1679031
SC0287,567.835955204216,567,28,636,608,1464844
SC0287,391.4345920841955,405,67,427,360,888581
PI534017,999.7282290490391,1014,7,1080,1073,3021281
PI534017,1110.341967878528,1112,4,1339,1335,3105135
PI534017,1350.3406410397713,1403,4,1515,1511,3547485
PI533769,1414.9476273349578,1421,273,1583,1310,4310943
PI533769,1368.2444907285685,1365,64,1502,1438,4147616
PI533769,1156.8568005620818,1179,5,1319,1314,3486037
SC0582,1349.1441146543411,1405,2,1612,1610,3952229
SC0582,1154.4682931822292,1174,2,1319,1317,3182283
SC0582,1530.0727364564843,1562,46,1656,1610,4553384
PI533969,1286.3437260001333,1310,10,1430,1420,3790410
PI533969,1382.1549019607844,1381,775,1533,758,4219537
PI533969,1295.6812730331162,1303,143,1445,1302,3955354
PI576338,1332.6643825379238,1362,4,1493,1489,3748162
PI576338,1172.9661028680614,1184,122,1324,1202,3546909
PI576338,977.1229878941213,981,28,1064,1036,2953944
PI533777,942.7490990990991,972,684,1032,348,2470021
PI533777,863.4339869281046,875,586,974,388,2376602
PI533777,1259.9699346405228,1262,571,1411,840,3849070
PI597982,506.14845938375345,483,399,641,242,1296184
PI597982,794.0344701275736,831,108,883,775,2154829
PI597982,916.474183006536,917,468,1128,660,2536998
PI533999,990.6411764705883,1019,474,1096,622,2760428
PI533999,808.692320261438,814,462,872,410,2224412
PI533999,741.6678104575163,772,481,843,362,2017076
PI533903,1077.2205882352941,1092.5,653,1179,526,3293083
PI533903,1247.022549019608,1295,752,1445,693,3813793
PI533903,1086.6852941176471,1068,536,1281,745,3322594
PI533801,1063.8124183006535,1063,769,1795,1026,3235286
PI533801,917.6738562091502,906,535,1083,548,2799074
PI533801,965.9277777777778,964,534,1180,646,2948174
PI534088,1042.6582770074542,1041,178,1240,1062,3181046
PI534088,995.7797385620916,960.5,688,1713,1025,3016557
PI534088,929.4265534925869,939,263,1092,829,2837868
PI659753,1337.4751633986928,1395,917,1542,625,4089779
PI659753,1079.9820261437908,1120,626,1253,627,3302470
PI659753,1232.6222222222223,1189,547,2391,1844,3753300
SC0159,1462.6896002042754,1581,423,1861,1438,4422138
SC0159,1230.424836601307,1200,468,1989,1521,3659168
SC0159,1288.1574101602132,1377,106,1721,1615,3501175
PI655981,1102.2529411764706,1126,864,1242,378,3370794
PI655981,925.5339869281045,937,573,1036,463,2577551
PI655981,1314.7490688512848,1327,580,1455,875,3646174
PI595729,1034.8741784037556,1034,381,1179,798,2911578
PI595729,1274.9545930701047,1279,1063,1381,318,3642809
PI595729,833.6511835364777,846,633,942,309,2301328
PI656109,705.1947977389154,685,545,875,330,1903767
PI656109,1187.9417770711889,1222,748,1280,532,3326871
PI656109,988.0627717490592,1051,22,1173,1151,2728389
PI534133,921.6035947712419,947,709,1099,390,2802657
PI534133,1036.4808732513159,1063,12,1200,1188,3065086
PI534133,1211.6526143790848,1204,654,1381,727,3699664
PI534102,907.6926249779192,910,178,1043,865,2459420
PI534102,695.3198495836691,645,418,928,510,1870853
PI534102,767.0095845644194,789,576,898,322,1992503
PI533963,1323.5839869281044,1354,929,1440,511,4040771
PI533963,972.275292924238,1035,21,1125,1104,2915852
PI533963,1082.4523933283504,1108,7,1227,1220,3081311
PI276837,1357.500163398693,1386,834,1454,620,3889468
PI276837,820.0643879173291,830,208,869,661,2253958
PI276837,1139.8026143790848,1122,1022,1360,338,3485723
PI597953,1107.933660130719,1131,861,1272,411,3382467
PI597953,993.9790849673202,1022,643,1262,619,3038939
PI597953,1065.8155877876266,1087.5,727,1157,430,2953908
PI656012,1148.0653594771243,1156,925,1921,996,3505416
PI656012,1211.1084967320262,1199,991,1391,400,3701618
PI656012,1327.9960784313726,1391,639,1490,851,4055872
PI534008,939.3709150326797,941,768,1015,247,2579087
PI534008,975.5555555555554,984,595,1090,495,2983053
PI534008,821.8359840232389,801,546,1032,486,2176187
PI576406,1403.4481522234778,1406,627,1714,1087,4204207
PI576406,1303.0687908496734,1320,1105,1356,251,3687169
PI576406,738.2830065359477,709,558,994,436,2249086
PI534141,898.8764705882352,887,710,1115,405,2748314
PI534141,1280.4993464052286,1305.5,1097,1426,329,3915416
PI534141,1341.5483301220297,1373,623,1491,868,3971498
PI576368,1056.6323848238483,1103,727,1231,504,2950491
PI576368,1274.9156862745094,1297.5,1079,1389,310,3608541
PI576368,1427.0451472826574,1440,1205,1582,377,4106314
SC0759,1121.0966731654162,1149,490,1217,727,3355822
SC0759,1053.2120915032679,1058,791,1153,362,3219242
SC0759,974.4303921568627,977,880,1037,157,2981757
PI533891,966.4032679738561,963.5,688,1170,482,2956872
PI533891,1070.1431372549018,1065,785,1223,438,3269556
PI533891,1094.3493464052287,1101,891,1266,375,3348439
PI533917,870.3969529595876,904,560,957,397,2258650
PI533917,859.9321112006446,880,338,934,596,2381045
PI533917,690.5774934383202,707,55,776,721,1831083
PI534020,1472.7268197071614,1545,319,1665,1346,4173939
PI534020,1272.6107843137254,1297,327,2851,2524,3805005
PI534020,1164.2895424836602,1194,822,1305,483,3560562
PI576383,794.1164027964663,804,342,912,570,2357089
PI576383,748.3591503267974,759,615,889,274,2287677
PI576383,771.291776790239,765,366,952,586,2336091
PI629059,1454.504853795693,1609,3,1757,1754,4096118
PI629059,1930.0295466977977,1976,6,2195,2189,5311682
PI629059,1321.792156862745,1333.5,460,1531,1071,3957189
PI534006,1341.8565359477125,1368,649,1460,811,4102350
PI534006,1318.6213179335662,1346,630,1403,773,3779530
PI534006,1597.104248366013,1639,953,1731,778,4885932
PI656003,1478.8712418300656,1508,902,1556,654,4265540
PI656003,1265.552923511747,1306,364,1422,1058,3608389
PI656003,1090.8720474236206,1081,873,1220,347,3052279
PI534077,768.7878643349231,766,568,924,356,2069193
PI534077,738.6908496732026,779,474,912,438,1997674
PI534077,723.5338481511326,741,485,801,316,1958970
PI574455,1745.7509690308834,1767,515,1910,1395,5302291
PI574455,1689.6419598889784,1650,1269,1936,667,4844093
PI574455,1839.9219298245614,1858,1642,1884,242,5224770
PI533848,835.9151219230325,840,345,997,652,2549768
PI533848,944.2508367426018,962,439,1040,601,2864790
PI533848,835.5950801325097,859,656,905,249,2141284
PI533866,1067.0264705882353,1106,578,1211,633,3261673
PI533866,1419.4267973856208,1428.5,1043,1531,488,4340996
PI533866,845.7065359477124,842,456,943,487,2142804
PI576362,1039.783660130719,1073,471,1271,800,3148483
PI576362,1031.503516391266,1056,417,1289,872,3145708
SC0854,1410.4216868883832,1496,360,1625,1265,4171365
SC0854,881.9970588235294,879,773,971,198,2698403
SC0854,1148.701633986928,1196,830,1277,447,3502520
PI656037,1757.2733258612247,1781.5,653,2035,1382,5319865
PI656037,1820.688996329125,1945,868,2104,1236,5226697
PI656037,1303.6754901960785,1360,446,1510,1064,3973090
PI656005,1060.7242994001253,1074,158,1110,952,2986381
PI656005,1244.2656136528688,1253,988,1460,472,3503002
PI656005,1308.7985294117648,1337,1080,1414,334,3748789
PI533893,1015.223202614379,1040.5,437,1175,738,3106171
PI533893,704.8094771241831,724,512,869,357,2153845
PI533893,804.6606738470035,812,627,913,286,2202206
PI576344,1529.5290849673202,1548,967,1715,748,4674956
PI576344,953.6447712418301,961,733,1004,271,2458990
PI576344,1757.0192810457515,1784,1381,1883,502,5365418
PI576344,1675.7751633986927,1717,1163,1822,659,5120041
PI576369,1543.937908496732,1593.5,840,1888,1048,4711354
PI576369,1545.2139582773746,1590,652,1655,1003,4465972
PI576369,1849.8173202614378,1846,1619,2074,455,5643358
PI576369,1433.1924836601306,1481,929,1646,717,4379838
PI533908,1434.6075163398693,1455,290,1563,1273,4363398
PI533908,1304.8549019607844,1307.5,577,2093,1516,3982801
PI533908,1349.1143790849674,1410,536,1991,1455,4109518
SC0150,888.385294117647,905,488,1076,588,2717460
SC0150,1220.5712418300654,1227,686,1527,841,3718066
SC0150,1381.899019607843,1366,1037,1611,574,4224736
PI534137,1594.2008021390375,1612.5,908,1703,795,4222306
PI534137,1429.4770000827334,1487,945,1577,632,4088814
PI534137,1250.4212418300654,1303,910,1499,589,3543267
PI534137,1347.8601307189542,1376,1027,1523,496,4093180
PI534114,916.4699346405229,930,762,1090,328,2799326
PI534114,1147.6784313725489,1137,1048,1918,870,3507131
PI534114,1180.201354731495,1224,459,1355,896,3600754
PI534074,916.0824499089254,959.5,24,1021,997,2468918
PI534074,927.7669934640523,924,490,1110,620,2835446
PI534074,888.559187149038,870,772,959,187,2453549
SC0556,1076.0714379084968,1104,762,1273,511,3003092
SC0556,957.6911764705883,960,579,1194,615,2924752
SC0556,957.4039215686275,959,691,1192,501,2923071
SC0556,1182.848202614379,1189,829,1382,553,3362883
PI552861,1490.965522875817,1552,707,1650,943,4244750
PI552861,1475.7392156862745,1501,620,1690,1070,4343633
PI534167,1427.2050464371232,1439,668,2719,2051,4048777
PI534167,1116.7872549019608,1171,585,1301,716,3416595
PI534167,1042.9662945940029,1075,18,1169,1151,2885276
PI534090,948.8813725490196,957,84,1089,1005,2899737
PI534090,1132.6882352941175,1175,722,1345,623,3456916
PI534090,1275.7718954248367,1244,296,1534,1238,3880790
PI656057,1824.430065359477,1879.5,772,2048,1276,5559140
PI656057,1395.0385620915033,1450,560,1598,1038,4259164
PI656057,1637.825163398693,1679,994,1778,784,4995311
PI534163,1642.488888888889,1678,842,1788,946,5010913
PI534163,1030.8739726027397,1034,875,1110,235,2895751
PI534163,1164.1176470588236,1158.5,1000,1231,231,3258059
PI595720,269.3148237956676,314.5,9,386,377,216379
PI595720,817.44139475346,872,141,1057,916,2417374
SC0999,1114.1387090536412,1166,424,1327,903,3289372
SC0999,1375.7656862745098,1407,816,1610,794,4205034
SC0999,1613.166339869281,1633,891,1935,1044,4905875
PI533958,1831.3614958219573,1808,1110,2024,914,5318772
PI533751,1520.1380273321452,1579,1059,1738,679,4205089
PI533751,1323.273478319548,1330,559,1417,858,4038709
PI533751,1205.0081699346406,1210.5,864,1395,531,3675357
PI533802,910.0773695489124,895,294,1334,1040,2694765
PI533802,1210.945808510228,1206,355,1355,1000,3685728
PI533802,1219.9258169934642,1251,155,1308,1153,3727183
PI533837,1930.4251633986928,1956,94,2076,1982,5890270
PI533837,1061.1454248366013,1071,203,1140,937,2991794
PI533837,1795.724469513833,1833,455,1897,1442,5231888
PI533798,1295.8921568627452,1316,467,1370,903,3962450
PI533798,1038.1709150326797,1053.5,871,1129,258,3173751
PI533798,1239.0869281045752,1248.5,957,1326,369,3783674
PI576330,2096.625163398693,2103,821,2332,1511,6356930
PI576330,1691.8302981466559,1673,106,2073,1967,4766030
PI576330,743.7878976613235,729,5,1721,1716,1903300
PI534035,1308.580065359477,1329,311,1529,1218,3988001
PI534035,1706.7046718217803,1701,763,1831,1068,4960076
PI534035,1348.5140040715742,1366,534,1470,936,4115299
PI534035,1585.7187178417466,1596,753,1807,1054,4558173
PI656089,1250.8088838809917,1306,492,1423,931,3810494
PI533966,1455.570825653113,1466,630,1576,946,4436284
PI533966,1309.343137254902,1317,1100,1987,887,3965830
PI533966,1059.0967320261439,1076,766,1170,404,3239814
PI534161,1210.7496732026143,1200,466,1343,877,3690688
PI534161,1459.179411764706,1451,660,1578,918,4457276
PI534161,1545.5244513820426,1585,327,1767,1440,4678337
PI534103,1123.5643790849672,1129,915,1238,323,3437344
PI534103,1284.7047775177152,1279,207,1501,1294,3897030
PI534103,968.0983660130719,1002,727,1131,404,2949616
PI656051,1798.5911764705882,1820.5,1035,2040,1005,5468283
PI656051,1873.8809964244047,1969,3,2157,2154,5446312
PI656051,1854.1244035894067,1848,725,2041,1316,5646481
PI533883,802.8632513977996,822,367,904,537,2431685
PI533883,855.6295973881922,885,2,924,922,1258623
PI533883,848.3503267973856,857,605,1096,491,2583326
PI534151,1391.1575163398693,1414,923,1554,631,4251539
PI534151,373.6161852618545,412,4,507,503,265251
PI534151,757.7933822353955,841,3,890,887,797238
PI533909,978.4493464052287,963.5,785,1129,344,2992204
PI533909,1038.6202614379085,1083,493,1165,672,3175005
PI533909,1034.4192810457516,1073,508,1159,651,3161826
PI533909,1366.0813489172033,1398,540,1501,961,4100247
PI595716,1507.640455461818,1527,562,1689,1127,4598535
PI595716,1630.6339869281046,1646,130,1954,1824,4899948
PI595716,1108.9098127539303,1100,910,1220,310,3131364
PI656039,1908.143785281697,1950,161,2323,2162,5780907
PI656039,1499.2886877828055,1537,825,1623,798,4310431
PI656039,1571.22034428795,1580.5,1197,1673,476,4553195
PI542406,1206.3014705882354,1263,256,1332,1076,3433886
PI542406,1188.067494851822,1175,557,1390,833,3368377
PI542406,1381.05,1411,883,1582,699,3963660
PI533784,1875.0510245539658,1863,1625,2047,422,5182069
PI533784,1752.1932862077379,1775,726,1870,1144,5342613
PI533784,1429.0186274509804,1433,714,1545,831,3889571
PI576386,1078.5058823529412,1109,861,1177,316,3298194
PI576386,1038.8761444776478,1113,3,1282,1279,3034281
PI576386,1372.1959509006851,1364,1169,1454,285,3837380
PI656099,1521.7143701316143,1526.5,904,1655,751,4386642
PI656099,1318.6784313725489,1308,1160,1419,259,3716952
PI656099,1076.1944444444443,1095,740,1340,600,3283312
PI576346,937.9114484150437,963.5,461,1124,663,2737046
PI576346,929.04477124183,979,460,1082,622,2825764
PI576346,1007.0898692810458,1050,742,1142,400,3069855
PI534078,1144.3003519716738,1209,559,1322,763,3351202
PI534078,734.0229994700583,747,59,838,779,1880364
PI534078,1232.3945429203181,1289,2,1405,1403,3535815
PI597951,324.1043746739185,344,5,379,374,674399
PI597951,673.2630718954248,671,550,774,224,1803217
PI597951,402.43739466949626,425,4,442,438,535680
PI656026,2086.171986939024,2162,3,2307,2304,5099243
PI656026,1007.0494741169192,1070,4,1171,1167,1282331
PI656026,1968.7106123151013,2029,174,2117,1943,4593957
PI656062,1196.4495836356305,1254,2,1496,1494,1926865
PI656062,1252.054248366013,1284,913,1403,490,3822929
PI656062,1511.3416383064655,1602,2,1726,1724,3927741
PI655976,1346.7214557782122,1409,4,1663,1659,2874094
PI655976,1351.1129747963137,1472,2,1569,1567,2291106
PI655976,1373.4129057606679,1453,3,1677,1674,3942320
PI629034,1487.6898692810457,1474,669,1643,974,4290872
PI629034,1685.0777777777778,1705,747,1822,1075,5132574
PI629034,1459.9257005673328,1491,2,1666,1664,4257138
SC1107,1375.2228758169936,1374,873,1593,720,4193489
SC1107,1449.502960216559,1473,2,1647,1645,3970026
SC1107,1441.8571895424839,1489,504,1640,1136,4399834
PI655979,1386.773202614379,1378,620,2108,1488,4231619
PI655979,1287.8747565911826,1289.5,494,1437,943,3896106
PI655979,2034.1089800239347,2044,1040,2205,1165,5816089
PI534007,1200.2954640009245,1198,567,1872,1305,3658195
PI534007,1036.2125868967728,1090.5,2,1313,1311,1094015
PI534007,310.22969606377677,326,2,407,405,190142
SC1023,1458.177225234329,1525,389,1640,1251,4419637
SC1023,1830.56568627451,1855,158,2055,1897,5589979
SC1023,1787.4428356122446,1813,1046,1993,947,5451203
PI595701,926.9388888888889,933.5,798,1038,240,2836200
PI595701,1412.3960670941779,1450,113,1563,1450,4233807
PI595701,1330.8599560550856,1346,636,1442,806,4051771
PI534019,1386.3974348643567,1370,600,1517,917,3973831
PI534019,1397.1521534556855,1439,146,1637,1491,4170568
PI534019,691.3394172104105,681,15,850,835,2101607
PI576429,1328.862142133849,1348,583,1452,869,3804181
PI576429,1232.741503267974,1235,999,1418,419,3759453
PI576429,1115.4916600279257,1148,609,1209,600,3403189
PI656016,1512.7320261437908,1530,575,1791,1216,4603431
PI656016,1492.7107843137255,1490,484,1726,1242,4553316
PI656016,1319.0879801235562,1307,182,1444,1262,3783021
PI533771,1310.138888888889,1319,1055,1457,402,3667865
PI533771,1198.6020249887192,1266,3,1326,1323,2454258
PI533771,1094.6870466135172,1134,516,1222,706,2782074
PI534156,1795.6539215686275,1802,1188,2117,929,5474011
PI534156,1833.652614379085,1880,370,2105,1735,5588283
PI534156,1976.3486928104574,2022,125,2256,2131,5959259
PI533946,1473.3573293230763,1487,505,1653,1148,4487514
PI533946,1004.2132287179977,1056,4,1132,1128,2987933
PI533946,1105.1893546271872,1182.5,2,1278,1276,1479039
PI533799,1417.2140522875816,1468,758,1597,839,4317219
PI533799,1743.077450980392,1742,1191,1903,712,5320851
PI533799,1522.2860921171464,1588,2,1688,1686,2841248
PI597957,1508.414705882353,1499,1020,1674,654,4610180
PI597957,1111.3387831372102,1142,12,1231,1219,3183847
PI597957,1407.2846405228759,1434,897,2505,1608,4299122
SC1114,806.1767973856208,806.5,486,1078,592,2461191
SC1114,857.0013071895424,863,424,1030,606,2610183
SC1114,1044.2353828060232,1072,183,1204,1021,3188194
PI276837,1269.3415032679738,1279,690,1408,718,3878887
PI276837,1600.5478722857838,1604,998,1707,709,4889613
PI276837,1678.1081699346405,1669,1188,1858,670,5122835
PI534127,1286.706405228758,1249,981,1608,627,3657713
PI534127,1098.3480392156864,1112,653,1165,512,3105340
PI534127,1012.3602941176471,1056,520,1227,707,2834501
PI533974,1214.4588235294118,1224.5,528,1395,867,3699990
PI533974,1460.0846405228758,1479,1261,1502,241,4206133
PI533974,1312.5496732026143,1320.5,1183,1366,183,3746292
PI656084,1407.656209150327,1404,1238,1539,301,4299196
PI656084,1443.2478097622027,1459,1147,1571,424,4108724
PI656084,1569.1107843137256,1584,923,1772,849,4796237
PI597962,2143.791245810701,2119,593,2397,1804,6529597
PI597962,954.3994896588772,982,495,1098,603,2667545
PI597962,836.6576797385621,892,461,948,487,2306285
PI533953,1107.3117647058825,1208,636,1315,679,3383883
PI533953,1040.0555555555557,1044,294,1373,1079,3174804
PI533953,1122.5647058823529,1189,797,1327,530,3426385
PI595712,1174.0443449285412,1154,525,1370,845,3570604
PI595712,1408.85,1408.5,818,1617,799,4283734
PI595712,1224.2277777777776,1225,700,1352,652,3741604
PI534077,766.6300653594772,719,538,1088,550,2344169
PI534077,702.4928104575163,693.5,491,892,401,2148566
PI534077,707.2803921568627,694,482,1009,527,2140913
PI595713,999.9980392156863,1023,612,1189,577,3055933
PI595713,1705.7287581699347,1706,1222,1855,633,5214146
PI595713,987.386288318144,955,727,1169,442,2754418
PI534074,770.2243790849674,769,651,843,192,2107198
PI534074,1076.1872549019608,1109.5,843,1232,389,3292902
PI534074,939.0326797385621,931,425,1092,667,2872678
PI542718,1899.6029411764707,1912,615,2204,1589,5673443
PI542718,1378.4839869281045,1405,933,1586,653,4191306
PI542718,1594.5281045751635,1635,445,2786,2341,4826655
PI534135,1320.149019607843,1328,870,1511,641,4034850
PI534135,1473.8709150326797,1498,983,1640,657,4501506
PI534135,1253.4382352941177,1272,442,1476,1034,3826030
PI656018,1760.1153594771242,1771,1365,1838,473,5376676
PI656018,1369.3045751633986,1383,1167,1517,350,4187385
PI656018,1365.3702614379085,1368.5,1190,2301,1111,4169261
SC0823,1109.3434528849716,1158,267,1291,1024,3177827
SC0823,1129.2627450980392,1161,619,1283,664,3450749
SC0823,1151.1823529411763,1148,988,1266,278,3514368
PI656036,1316.5277777777778,1336,890,1475,585,3962176
PI656036,1304.3666666666668,1361,759,1603,844,3973771
PI656036,1158.7979420597069,1193,811,1336,525,3287149
PI534096,1030.577450980392,1073,576,1153,577,3150600
PI534096,937.7838191942352,936,66,1374,1308,2554247
PI534096,1343.9398003237993,1366,347,1438,1091,4090129
PI534133,1049.138071895425,1061,764,1156,392,2954013
PI534133,1387.881266445972,1416.5,1044,1541,497,3980400
PI534133,1206.8578431372548,1158,637,1427,790,3437452
PI656121,1042.6952795933187,1096,640,1230,590,2911273
PI576328,1592.1156415077446,1619,1195,1718,523,4610904
PI576328,1401.4467767929086,1423,1106,1513,407,4027298
PI576328,1491.3470588235296,1507,1274,1601,327,4550802
PI533792,1090.7601307189543,1102,857,1213,356,3333400
PI533949,1150.9686274509804,1177,716,1287,571,3509574
PI533949,1412.0254901960784,1426,1236,1537,301,4318150
PI533949,1592.5398692810459,1610,858,1755,897,4850452
PI534051,1407.0557616826845,1461,322,1574,1252,4287962
PI534051,1283.940216299299,1334,53,1503,1450,3874235
PI534051,1238.6065359477125,1242,948,1357,409,3773138
SC0685,997.1321674564905,1000,8,1093,1085,3028678
SC0685,989.4691797301548,980.5,60,1164,1104,2746773
SC0685,1091.9973811442387,1091,635,1151,516,3068857
PI656100,1437.6066851937626,1438,214,2507,2293,4319729
PI656100,1723.3556121517508,1836,285,2094,1809,5209757
PI656100,1518.2309392454438,1525,46,2168,2122,4620889
PI533914,1196.2352915478118,1201.5,72,1379,1307,3641982
PI533914,1567.6964847200143,1603,441,1813,1372,4412367
PI533914,1157.6328229922103,1170.5,806,1341,535,3280973
SC0247,727.8575808798655,742,47,910,863,2219867
SC0247,658.1375816993464,685,220,884,664,1978223
SC0247,889.40522875817,883,240,1145,905,2719184
SC0276,708.5245395127748,736,28,1097,1069,2000854
SC0276,699.3271241830066,736,194,1100,906,2128365
SC0276,961.6259981101944,962,283,1198,915,2921780
SC0276,1088.7392998888868,1106,6,1214,1208,3242739
PI533819,1118.6164153897587,1187,5,1318,1313,3026318
PI533819,1112.6294939334398,1170,2,1299,1297,2685168
PI533819,1090.6417693025542,1120,3,1209,1206,2756060
PI533819,1097.9493260160393,1123,3,1208,1205,2903225
PI576407,1259.2437317437307,1356,2,1616,1614,2063654
PI576407,596.6616169755573,604,445,662,217,1488862
PI533774,1305.7516930042457,1334,564,1492,928,3924718
PI533774,1324.1491233224626,1318,68,1439,1371,4002870
PI533774,1066.368245309743,1062,155,1187,1032,3251127
PI533774,1070.6581699346405,1070,697,1199,502,3271623
PI576409,875.905882352941,892,421,1074,653,2677990
PI576409,1047.3409259489797,1096,15,1290,1275,3181012
PI576409,1242.879093869251,1299,214,1451,1237,3781759
PI534058,793.9542483660131,811.5,147,1063,916,2330209
PI534058,1054.1290849673203,1062,189,1138,949,3204760
PI534058,410.5099355824872,422,76,473,397,981243
PI595739,1204.6354131684595,1275.5,3,1407,1404,2200752
PI595739,742.5526464606919,690,360,1068,708,2253590
PI595739,1319.9436020192773,1408,303,1561,1258,3159884
PI576427,1171.7414752074321,1214,43,1351,1308,3540426
PI576427,1181.7708507024859,1221.5,554,1356,802,3591745
PI576427,1323.9985867789646,1376,3,1526,1523,3121653
PI576427,1134.2542576967098,1158,233,1338,1105,3295053
PI534144,1442.2268996330884,1520,4,1568,1564,3146334
PI534144,1392.2106591202414,1443,2,1546,1544,3587240
PI534144,1427.0209539937027,1452,2,1708,1706,3868289
PI597969,1079.8114379084968,1106,606,1167,561,3296254
PI597969,1604.049019607843,1629,1234,1724,490,4881850
PI597969,1588.8801258451438,1620,11,1886,1875,4643464
PI656028,901.1301473594903,967,360,1142,782,2713965
PI656028,1198.919934640523,1222,997,1349,352,3663241
PI656028,986.1944444444445,915,530,1210,680,2980287
SC0847,1307.7711992043194,1302,340,1713,1373,3579909
SC0847,1453.736566671485,1515,2,1673,1671,3933166
SC0847,936.1543384457641,986,3,1384,1381,2333138
PI533835,1590.5872549019607,1572,1208,2392,1184,4854792
PI533835,1431.1293179085906,1457,219,1715,1496,4038209
PI533835,1306.6254587067604,1392,356,1636,1280,3476127
PI576425,1220.5607217940506,1243,488,2096,1608,3588819
PI576425,1165.694160624198,1234,12,1319,1307,2981343
PI576425,1288.5810065359478,1294.5,324,1443,1119,3797946
PI534155,1410.1718728695423,1462,2,1707,1705,3785935
PI534155,1814.4091503267975,1838,98,1926,1828,5524461
PI534155,1574.9495668820323,1616,6,1798,1792,4698503
PI534032,1292.0957615857465,1312,2,1442,1440,3644354
PI534032,1789.1942321839547,1847,49,2043,1994,5132334
PI534032,1629.7854611974954,1644,215,1837,1622,4719102
PI534080,460.1222222222222,487,226,596,370,1127046
PI534080,1022.7232012881807,1082,167,1384,1217,3000213
PI534080,1491.2675328700043,1491,20,1772,1752,4409343
SC0747,1130.6780940455847,1189,4,1238,1234,3082767
SC0747,990.1707295822896,1068,4,1211,1207,2384978
SC0747,1249.634274131176,1262,300,1494,1194,3575212
PI534108,1233.5033046209992,1237,599,1356,757,3690406
PI534108,1352.876422805833,1430,8,1521,1513,3511167
PI534108,1340.6022875816993,1343,1104,1459,355,4099951
PI655970,1658.0045987184237,1652,524,1967,1443,4820114
PI655970,944.3637254901961,947,707,1138,431,2886891
PI655970,1104.0447996618893,1117,215,1241,1026,3340650
PI656113,1707.622549019608,1645,703,2050,1347,5153465
PI656113,1287.1001897392362,1345,20,1473,1453,3158599
PI656113,1656.8099673202614,1696.5,634,1967,1333,4902957
SC0235,1119.844253845804,1120,3,1244,1241,3400513
SC0235,1274.9579736554006,1333,130,1460,1330,3601404
SC0235,1293.7801682937677,1372,15,1479,1464,3095433
PI533996,1069.796937039138,1085,7,1205,1198,2376585
PI533996,1067.5665987645953,1086,6,1207,1201,2328319
PI533996,1257.2073269369023,1299,33,1437,1404,3545021
PI533996,739.5559612882464,747,2,931,929,1302177
PI595725,1220.7011121529406,1223,3,1320,1317,3488893
PI595725,1064.6203816285365,1099,2,1161,1159,2903622
PI595725,948.2479738562091,975,732,1000,268,2582545
SC0923,1051.5193482702307,1074,18,1231,1213,2560669
SC0923,1643.968214857231,1645,399,1925,1526,4954570
SC0923,1626.6423604240122,1695,2,1905,1903,3964641
PI533861,1640.9780795316628,1820,2,1979,1977,3875725
PI533861,1392.324704661044,1404,2,1770,1768,3781413
PI533861,1491.072552529784,1528,682,1716,1034,4279459
PI534071,925.9553108680658,973,353,1181,828,2013151
PI534071,886.1927953995378,897,2,1088,1086,2524914
PI534071,901.1460699431287,904.5,744,1018,274,2485686
PI656058,1278.8763140341357,1301,5,1628,1623,3602768
PI656058,1225.2102886783941,1285,13,1517,1504,2923336
PI656058,1349.0678235152636,1375,6,1565,1559,3709812
PI576336,729.2882352941176,728,478,928,450,2230037
PI576336,1084.062688574436,1087,399,1268,869,3249393
PI576336,916.1624183006536,920,406,1000,594,2801821
PI534057,1237.361614674271,1289,2,1389,1387,3356969
PI534057,1283.724513289148,1363,7,1484,1477,3549570
PI534057,1438.7622902163941,1467,2,1653,1651,3774462
PI533796,1187.804536870287,1226,2,1458,1456,3288865
PI533796,1161.5361892086191,1206,13,1371,1358,3286600
PI533796,1254.6433056621408,1268,68,1372,1304,3735911
PI533982,1036.5883275990745,1073,89,1149,1060,2703391
PI533982,1059.765434792732,1101,6,1297,1291,2933271
PI533982,1434.1898193996426,1453,520,1689,1169,4173368
SC0582,1300.5179432692617,1329,592,1553,961,3930084
SC0582,1269.3181963999086,1246,599,1483,884,3739119
SC0582,1494.3718954248366,1524,62,1641,1579,4479230
PI656006,1399.787431372549,1442,604,1694,1090,4235019
PI656006,1303.2234857939497,1354,11,1466,1455,3797081
PI656006,1048.956862745098,1055,572,1209,637,3171371
SC0741,1675.4843137254902,1679,976,1845,869,5112281
SC0741,1938.1006535947713,1928,1226,2232,1006,5912796
SC0741,939.9996928829639,967,499,1056,557,2669482
PI576419,746.8653569710222,769,3,887,884,1896003
PI576419,772.6358767101275,811,2,999,997,1780153
PI576419,792.9885620915032,801,306,924,618,2421022
SC0636,1186.486274509804,1214,999,1983,984,3601550
SC0636,780.9683740373995,824,7,905,898,2298345
SC0636,979.0817630234075,1041,15,1202,1187,2809923
PI576413,1160.958496732026,1148,1048,1861,813,3536025
PI576413,1517.415204780137,1585,506,1651,1145,4453641
PI576413,1231.0779674666878,1210,557,1391,834,3672298
PI595733,1464.7847237116769,1496,670,1589,919,4365450
PI595733,1352.9328180841417,1453,2,1501,1499,3278321
PI595733,1848.7094771241832,1877,1488,1986,498,5636833
PI564165,957.5072487819964,975,422,1049,627,2891895
PI564165,1510.0041109087042,1550,682,1638,956,4188600
PI564165,1805.300730934292,1899,721,2139,1418,5032500
PI534165,1447.0646405228758,1496,974,1599,625,4166832
PI534165,1258.4529411764706,1271,973,1471,498,3847605
PI534165,1215.648229508041,1307,3,1411,1408,3327448
PI534062,1516.0519805303793,1537,522,1693,1171,4509459
PI534062,1556.0866013071895,1538,683,1866,1183,4736295
PI534062,1475.0880248323708,1462,750,1692,942,4322103
PI655986,1536.6361197595952,1601,726,1682,956,4452464
PI655986,1791.176125549017,1852,2,2055,2053,3656392
PI655986,1383.3120137477804,1479,2,1604,1602,2733909
PI534089,693.4687357305936,727,2,891,889,1016419
PI534089,690.0512427821359,783,5,855,850,570224
PI534089,522.2287746803456,547,2,671,669,574035
PI533857,1700.1248366013072,1707,1408,1935,527,5145797
PI533857,1145.7241839335356,1134,4,1427,1423,2559781
PI533857,951.168612584517,880,2,1378,1376,2551766
PI534160,1184.2333333333333,1209,930,1362,432,3611470
PI534160,1423.6699564396863,1485,9,1647,1638,4085799
PI534160,878.6264705882352,858,719,1052,333,2682884
PI533850,1115.8915877882948,1172,2,1288,1286,2977846
PI533850,1670.0914652079289,1758,668,1883,1215,4082830
PI533850,1443.8965768002038,1455,665,1677,1012,4245180
SC0870,1163.8876324674686,1193.5,4,1405,1401,3066094
SC0870,1595.147229019351,1638,745,1777,1032,4867910
SC0870,1598.9901960784314,1639,900,1779,879,4881291
SC0870,1299.4507617759746,1308.5,324,1557,1233,3809814
SC0870,1292.087531714632,1306,296,1499,1203,3812597
PI656052,834.6114379084968,848,523,1044,521,2538628
PI656052,1666.7027201359854,1689,584,1819,1235,5031005
PI656072,1570.1702614379085,1592,602,1673,1071,4800108
PI656072,1197.7977124183008,1176,913,1453,540,3657951
PI656072,1064.7607843137255,1023.5,807,1396,589,3253822
PI533888,958.6343997248023,964,764,1080,316,2552594
PI533888,498.87248366013074,528,287,577,290,1264017
PI533888,987.5153594771242,1025,815,1085,270,3021507
SC0178,1269.2170800725119,1276,574,1436,862,3539680
SC0178,1021.652309343347,1102,16,1294,1278,2109739
SC0178,1488.674138409717,1532,10,1700,1690,4176508
SC0438,886.4175605907225,921,5,1053,1048,1913868
SC0438,993.322940341142,1039,4,1260,1256,2715841
SC0438,831.1990134770324,850,4,980,976,2376848
PI533870,1064.2216813720643,1101,2,1362,1360,2775085
PI533870,1389.2934640522876,1417,1057,1632,575,4240583
PI533870,1583.2445377707654,1609.5,10,1947,1937,4457519
PI533870,1585.206002861531,1611,5,1952,1947,4470940
PI533877,403.45472749677924,461,4,594,590,199586
PI533877,644.2443853281604,711,3,913,910,744515
PI533877,173.83013698630137,179,62,184,122,12821
SC0041,1111.018372817714,1161,3,1392,1389,2532584
SC0041,141.95919030363615,149,4,215,211,28486
SC0041,1175.4813465475477,1208.5,2,1418,1416,2291244
SC1193,814.3624080078225,818,315,898,583,2430304
SC1193,1015.0567908625478,1036,404,1163,759,3067858
SC1193,1100.0643790849672,1115,397,1223,826,3352464
PI533769,607.136169406251,638,52,713,661,1456976
PI533769,1038.3470588235293,1048,868,1176,308,3177128
PI533769,1489.0349673202613,1518,1239,1645,406,4555297
PI533769,1507.3480723210655,1523,1030,1754,724,3881280
PI533769,1587.771568627451,1593,1372,1762,390,4844236
PI656112,1409.5503267973857,1421,487,1638,1151,4249940
PI656112,1889.6506535947713,1910,1017,2080,1063,5741109
PI656112,1726.7166666666667,1718,1499,1927,428,5264462
PI576373,1276.286928104575,1236,850,1865,1015,3889295
PI576373,992.8737321088772,963,766,1194,428,2575885
PI576373,1388.8863282299221,1386,1146,1495,349,3848020
PI656116,1011.5370841198301,1030,359,1218,859,3073658
PI656116,1419.3689464648658,1464,313,1587,1274,4210454
PI656116,776.7468115173997,763,582,891,309,2119475
SC0201,1674.810130718954,1739,1280,1931,651,5101771
SC0201,1702.4163398692808,1689.5,228,2514,2286,5091637
SC0201,1526.2071895424838,1513,1327,1727,400,4619636
PI576404,889.2607515732593,972,4,1188,1184,1745499
PI576404,856.4381436559715,949,3,1192,1189,1879344
PI576404,750.3876788553259,725,512,951,439,2035493
PI576404,1084.4934640522877,1037,762,1374,612,3315919
PI629040,1214.8808337749515,1250,490,1339,849,3345097
PI629040,1597.9195390436876,1579,1336,1812,476,4628842
PI629040,1823.0741314069487,1825,1560,1997,437,5187819
SC0517,1065.4235294117648,983,700,1995,1295,3232401
SC0517,934.3743684861331,970,700,1123,423,2400236
SC0517,880.8911764705882,881,645,1118,473,2687032
PI534050,1592.4160130718956,1620,1022,1830,808,4839980
PI534050,1349.2071895424838,1338,437,1507,1070,3934437
PI534050,1440.1660130718956,1449,1218,1609,391,4366220
PI534099,1158.8777777777777,1146,882,2025,1143,3543832
PI534099,1446.7787581699345,1431.5,611,1719,1108,4419065
PI534099,1425.6509803921567,1452,1138,1793,655,4282707
PI597962,1341.1813725490197,1366,626,1514,888,4017112
PI597962,1707.1849673202614,1769.5,1022,2036,1014,5187338
PI597962,2469.4434640522877,2275,1860,3479,1619,6482045
PI597962,2822.2156862745096,3005.5,2032,3487,1455,6721697
SC0003,1166.4754901960785,1228,651,1404,753,3445206
SC0003,1184.4595207450675,1214,2,1349,1347,3168076
SC0003,929.2870535116101,956,2,1149,1147,1755997
PI656002,1166.2313163744607,1185,12,1398,1386,3350626
PI656002,1298.1454248366013,1300,1152,1401,249,3950940
PI656002,1272.2961354525635,1294,35,1446,1411,3541479
PI533914,1694.7918300653596,1731.5,1200,1936,736,5165601
PI533914,1172.1712418300654,1137,918,1477,559,3557438
PI533914,1089.1909356725146,1127,854,1225,371,3079361
PI656044,1941.8820261437909,2006,1052,2181,1129,5675884
PI656044,1881.940065359477,1896,801,2120,1319,5497095
PI656044,2054.7676470588235,2007,1735,2354,619,6009622
PI576394,993.0606550491066,1033,3,1146,1143,2840410
PI576394,843.9871024643871,899,72,1083,1011,2097815
PI576394,1230.8018419334126,1327,5,1447,1442,2867968
PI533880,717.6925846094546,766,2,883,881,2050678
PI533880,1212.484640522876,1287,831,1431,600,3394805
PI533880,1088.7650326797386,1097.5,824,1285,461,3318396
PI533833,1359.3748366013072,1420,1048,1526,478,4156233
PI533833,1334.8689542483662,1328,1055,1545,490,4072163
PI533833,1095.6022875816993,1174,653,1335,682,3343868
SC1120,1575.7107843137255,1596,463,1817,1354,4791693
SC1120,1313.5484126984127,1320,919,1447,528,3672348
SC1120,1338.033785822021,1363,1088,1499,411,3682645
PI576359,1203.9267973856208,1229,925,1432,507,3658030
PI576359,1209.4313725490197,1266,818,1506,688,3619756
PI576359,1713.3235379000084,1775.5,922,1854,932,4938074
PI656095,1179.0823529411764,1212,740,1361,621,3606418
PI656095,1417.347385620915,1508,787,1630,843,4333357
PI656095,1202.3091503267974,1221.5,921,1333,412,3678958
PI656013,995.7596732026144,998,652,1128,476,2536863
PI656013,1177.624183006536,1193,999,1265,266,3586665
PI656013,1324.5528828197946,1308,848,1473,625,3883808
PI533965,1546.2576367389063,1568,1194,1757,563,4475041
PI533965,1796.0833849329206,1827,1452,1900,448,5237373
PI533965,1259.971968046478,1277,1029,1397,368,3595489
PI656107,2168.2261437908496,2221,1443,2575,1132,6561594
PI656107,1624.343137254902,1656,1108,1940,832,4937424
PI656107,1601.9885620915034,1619,1320,1814,494,4892833
PI534028,1559.493137254902,1576,455,1945,1490,4746525
PI534028,1569.9359477124183,1633,951,1823,872,4768273
PI534028,1524.8257335699345,1609,12,1841,1829,4264259
PI576390,817.060400032427,847,2,999,997,2099018
PI576390,634.7650336534753,672,2,909,907,1260691
PI576390,1180.859635395138,1144,3,1609,1606,2896348
PI534070,982.0470523598937,1010,7,1155,1148,2700348
PI534070,1004.19243043429,1009,5,1199,1194,2676215
PI534070,878.9768044948167,907,3,1148,1145,2056002
PI533786,998.3941085474175,1017,8,1096,1088,3003848
PI533786,1182.6250458953969,1225,9,1351,1342,3102449
PI533786,1473.5062091503269,1486,1155,1629,474,4393918
PI576412,989.2572084462465,970,172,1339,1167,2869809
PI576412,1417.7591503267972,1429,1090,1587,497,4320661
PI576412,1163.6205882352942,1150,1040,1259,219,3560040
PI533762,1288.8140522875817,1290,1101,1883,782,3933473
PI533762,1583.816339869281,1628.5,1176,1924,748,4824829
PI533762,1095.2451433474077,1201,259,1402,1143,3329429
PI533791,868.1520771779032,856,664,992,328,2310454
PI533791,718.5413071895425,726,578,766,188,1941671
PI533791,1114.6688141923437,1121,945,1191,246,3073383
PI533787,979.2081699346406,982,335,1140,805,2988526
PI533787,1280.8105882352943,1292,1050,1379,329,3629738
PI533787,1237.513725490196,1261,990,1341,351,3784767
PI533773,1317.5398692810459,1351,889,1496,607,4024142
PI533773,1095.156862745098,1124,771,1231,460,3346094
PI533773,970.9830065359477,1020,729,1076,347,2935593
PI656025,1532.2870142423167,1544,419,1785,1366,4513070
PI656025,1631.5316993464053,1669,668,1884,1216,4895821
PI656025,1537.2153594771241,1561,1285,1737,452,4692931
PI576331,1143.7937908496733,1148,802,1360,558,3478610
PI576331,969.4036312379029,1051,185,1269,1084,2594675
PI576331,961.4006535947713,960,664,1159,495,2924605
SC0814,2978.7169934640524,2939,2646,3365,719,7353087
SC0814,1632.0947712418301,1641,470,1891,1421,4724940
SC0814,2002.9552287581698,2057,1272,2357,1085,5984538
SC0276,949.0990196078432,970,701,1093,392,2895157
SC0276,858.963725490196,868,625,1039,414,2625452
SC0276,835.2687325548366,895,2,952,950,2277681
PI533864,1321.90269940482,1383,388,1533,1145,3951817
PI533864,987.1522875816995,1025,680,1155,475,3011050
PI533864,1183.7551931100675,1206,3,1351,1348,3523973
PI533824,1493.9216906946265,1584,401,1688,1287,4537785
PI533824,1807.511111111111,1867,1154,2077,923,5466266
PI533824,1658.9088235294116,1664,1332,1856,524,5047130
PI533821,1835.8069164618091,1861,268,2039,1771,5525568
PI533821,1428.0659229666771,1456,27,1563,1536,4311443
PI533821,1693.9719164600938,1726,123,1872,1749,5121587
PI533821,1563.6002225785674,1579,15,1712,1697,4715150
PI576343,1418.9629872256796,1432,89,1779,1690,4304500
PI576343,953.9644633477432,960,33,1019,986,2639486
PI576343,1390.0558404971184,1398,29,1640,1611,4166536
PI534043,1137.4891190187573,1154,11,1251,1240,3420397
PI534043,1452.8452898390574,1422,57,1629,1572,4163873
PI534043,1429.2818910217834,1439,89,1563,1474,4322237
PI576391,1347.850144641275,1361,31,1459,1428,4066235
PI576391,1533.2423470394187,1577,61,1660,1599,4626677
PI576391,1189.7707184444305,1200,11,1315,1304,3595547
SC0636,1427.4967320261437,1465,1137,1606,469,4328541
SC0636,1314.88954248366,1312.5,1021,1505,484,3930732
SC0636,1501.9280172579838,1528.5,578,1692,1114,4553783
PI533860,1405.14477124183,1403,1157,1550,393,4299148
PI533860,1663.0415294992022,1679,96,1842,1746,4960787
PI533860,1197.1802196107128,1226,493,1343,850,3453468
PI533926,692.598527862083,702,5,825,820,2011460
PI533926,1180.6633986928105,1243,740,1356,616,3597529
PI533926,1042.8767997405316,1079,359,1917,1558,3032345
PI533898,727.9751008478404,822,3,906,903,1951387
PI533898,853.8624711981568,902,2,1068,1066,2489921
PI533898,1128.4165353179583,1131,517,1325,808,3342095
PI613536,1867.341100422669,1933,588,2152,1564,5434578
PI613536,2181.137908496732,2229,794,2447,1653,6594299
PI613536,1383.8532679738562,1401,1055,1530,475,4197348
PI656108,1314.0372549019608,1313.5,1061,1466,405,4008118
PI656108,1416.326797385621,1462,242,1578,1336,4312472
PI656108,1498.0454248366013,1492,868,1671,803,4547971
PI656050,1067.7660130718955,1116.5,872,1199,327,3258068
PI656050,1222.0718954248366,1233,792,1393,601,3722161
PI597947,1185.543137254902,1207,904,1896,992,3617960
PI597947,956.8675196850393,965,462,1146,684,2910128
PI597947,1223.2937908496733,1218,1053,1345,292,3727963
SC0834,1388.7339869281045,1393,1094,1517,423,4234674
SC0834,1637.817320261438,1646,378,1790,1412,4903333
SC0834,1222.9330065359477,1257.5,802,1469,667,3680675
PI533784,1272.2236464210478,1372,438,1500,1062,3522308
PI533784,1147.3882352941177,1149,923,1230,307,3505177
PI533784,662.0264234934556,704.5,2,1033,1031,1327209
PI533883,733.3667492643707,778,3,932,929,1546871
PI533883,868.9937908496731,883,617,1065,448,2656379
PI533883,992.621568627451,973.5,556,1177,621,3033227
SC0923,1157.7330065359479,1145,837,1383,546,3471250
SC0923,1725.8058823529414,1799,1349,2015,666,5256737
SC0923,247.40784363390748,274,47,332,285,111945
PI597943,1290.4183006535948,1278,928,2034,1106,3933345
PI597943,1179.5388888888888,1173.5,1010,1340,330,3603974
PI597943,1593.7248366013073,1553,1323,1820,497,4871122
PI597954,1421.7496732026143,1439,1140,2169,1029,4304030
PI597954,1181.9653594771244,1161.5,510,1408,898,3590586
PI597954,1156.7895424836602,1169,833,1371,538,3528082
PI576353,1305.5671241830066,1331,984,1367,383,3722592
PI576353,1241.9937908496731,1284,551,1458,907,3792079
PI576353,1240.9156862745099,1236,900,1456,556,3783111
PI595747,1448.0225490196078,1455,1131,1642,511,4421051
PI595747,1282.4565359477124,1257,1044,1529,485,3917900
PI595747,1165.0270105632567,1262,2,1358,1356,2895453
PI629040,1715.6707908239748,1753,708,1971,1263,5194845
PI629040,1312.9728758169936,1314,1120,1408,288,4016317
PI629040,1048.3372549019607,1056,637,1274,637,3182868
PI533922,1839.6401960784312,1843,889,2162,1273,5610989
PI533922,1337.9476894178981,1400,599,1608,1009,3540999
PI533922,984.1836305776133,1004,319,1100,781,2994019
PI534099,1540.0104575163398,1572,1185,1661,476,4699206
PI534099,1101.2575163398692,1111,768,1223,455,3361311
PI534099,1298.5084967320263,1313,984,1422,438,3965133
PI576410,1191.385294117647,1154,937,1437,500,3633924
PI576410,1380.5225490196078,1418,1176,1509,333,4201496
PI576410,1459.354248366013,1461,1139,1631,492,4380174
PI533824,1342.7930580183142,1368.5,497,1512,1015,4091587
PI533824,1552.8954248366013,1583,1226,1765,539,4735534
PI533824,1806.5650326797386,1849,757,2054,1297,5505267
PI533947,1080.3442148030383,1168,625,1228,603,3035854
PI533947,1408.8875816993464,1433,1133,1590,457,4305038
PI533947,990.8660782230843,970,36,1226,1190,2850187
PI533845,1027.914552662595,1047,301,1248,947,3125513
PI533845,1201.9604575163398,1216,944,1376,432,3673963
PI533845,1154.9529411764706,1162.5,954,1367,413,3506991
PI576373,1439.0032679738563,1438,1225,1587,362,4394527
PI576373,1054.736760227216,1080,5,1151,1146,3009877
PI576373,1199.3267490639923,1183,590,1343,753,3459023
PI576370,1396.9603045071594,1402,655,1658,1003,4141199
PI576370,1482.8496732026144,1501,636,1601,965,4521756
PI576370,903.6095376148955,941,306,1065,759,2528248
SC0517,681.8965254935649,690,2,883,881,1874455
SC0517,436.9391124871001,426,11,692,681,1058523
SC0517,1177.8238562091503,1236,378,1338,960,3464405
PI576414,982.1695097851091,1017,2,1177,1175,2432910
PI576414,753.6452471861186,719,7,1238,1231,1463887
PI576414,1115.8567145191753,1205,3,1360,1357,1725956
PI533975,180.94017094017096,194,5,204,199,28597
PI533975,257.71213062383526,292,3,331,328,44586
PI533975,116.636544011544,124,14,128,114,8784
PI533813,1703.7781045751633,1751,715,2972,2257,5152071
PI533813,1075.7559734951165,1112,17,1292,1275,3243166
PI533813,1309.266920429197,1434,7,1670,1663,3826136
PI656069,1341.504661428687,1384,10,1555,1545,3813553
PI656069,1435.7924836601305,1435.5,634,1708,1074,4380973
PI656069,1078.7490196078431,1094,875,1239,364,3295307
PI533776,1295.986274509804,1328,971,1450,479,3888776
PI533776,1195.8964620909264,1191,31,1410,1379,3468131
PI533776,732.4107401063386,765,190,905,715,2068070
PI534043,1129.1522875816995,1154,507,1200,693,3449968
PI534043,1525.5776785812695,1553,92,1756,1664,4555513
PI534043,1266.9444444444443,1286,574,1350,776,3871102
SC0436,944.9604080861011,1026,2,1176,1174,2637125
SC0436,1302.6222222222223,1359,832,1582,750,3941703
SC0436,1094.1366013071895,1111.5,559,1245,686,3341135
PI656106,1416.2607843137255,1444,804,1591,787,4329973
PI656106,1244.548758697027,1292,72,1434,1362,3670048
PI656106,1509.060997112023,1594,774,1733,959,4071537
PI533866,1041.8054003508973,1075,350,1242,892,3158689
PI533866,837.4041759270228,852,2,951,949,2389876
PI533866,1458.8716441186402,1480.5,243,1606,1363,4324656
PI576416,915.1627450980392,952,538,1101,563,2788161
PI576416,1116.774926539644,1168.5,4,1319,1315,3134842
PI576416,932.1186557750073,997,139,1083,944,2615338
PI533823,967.9094519859225,1050.5,2,1140,1138,1036048
PI533823,162.62091038406828,173,13,176,163,12185
PI533823,1218.193241003374,1385,2,1591,1589,2729993
PI533855,1110.7960784313725,1130,851,1329,478,3398167
PI533855,1161.987908496732,1205,872,1312,440,3521955
PI533855,1448.8571895424839,1485.5,1146,1632,486,4427620
PI533836,958.6878232524718,1009,2,1184,1182,2394235
PI533836,1417.764705882353,1420,1108,1579,471,4300447
PI533836,1018.4240557579964,1059,2,1229,1227,2512213
PI595738,1526.8653594771242,1542.5,692,1724,1032,4667866
PI595738,1718.1869281045751,1739,1383,1850,467,5246191
PI595738,1223.917973856209,1243,1027,1391,364,3741615
PI533886,817.5723910065699,897,2,983,981,904225
PI533886,956.3151074448504,1012,3,1173,1170,2005675
PI533886,868.2961943456622,922,5,1072,1067,1732908
PI656058,1366.655241452762,1434.5,59,1734,1675,2611365
PI656058,1610.8884994093607,1664,2,1984,1982,3998802
PI656058,1242.4116551004602,1454,2,1615,1613,2317883
PI576345,1436.8643473544062,1490,13,1766,1753,3587504
PI576345,1712.0987306828713,1799,2,1898,1896,2736543
PI576345,1144.8134286524107,1229.5,3,1630,1627,2825428
PI533971,423.04797668249955,485,5,568,563,337780
PI533971,1119.5797105854995,1134,2,1252,1250,3210463
PI533971,1223.2823938042561,1230,566,1334,768,3709484
PI533785,703.3029871156808,663,16,1063,1047,889830
PI533785,1384.2048574874384,1456,18,1630,1612,3668205
PI533785,756.2961248649303,775,2,926,924,1451361
PI533885,255.56876680752978,273,18,282,264,27347
PI533885,166.93766233766235,177,17,180,163,12685
PI533885,166.6578947368421,178,14,181,167,12666
PI576387,1514.1045973570003,1560,5,1893,1888,4265808
PI576387,1254.917862900354,1328,3,1453,1450,3050837
PI576387,1390.2767201570077,1434,135,1564,1429,4061394
PI629059,270.4664566345441,312.5,8,397,389,58727
PI629059,547.1708172320023,608,2,799,797,343582
PI629059,1998.572632132655,2262,2,2421,2419,3192715
PI656005,933.8814841343376,979,4,1149,1145,2195269
PI656005,1797.6977124183006,1849,1405,1960,555,5465043
PI656005,1010.0512915696524,1038,446,1122,676,2873211
PI576436,1446.4295709743951,1516,4,1647,1643,2162059
PI576436,1134.1759928218278,1218,2,1359,1357,2863295
PI576436,1654.5572695744966,1709,417,1843,1426,4858500
PI656000,1277.8584147453432,1311.5,2,1435,1433,2664010
PI656000,981.9791337600242,1018,2,1287,1285,2099416
PI656000,1672.5766493078272,1704,6,2050,2044,4279090
PI534010,1241.2133279734117,1294,2,1462,1460,3459975
PI534010,1356.2068389896888,1358,1038,1537,499,4131236
PI534010,1309.197317689568,1347,4,1495,1491,3767243
PI565121,1796.2751633986927,1812,259,1995,1736,5363271
PI565121,1663.6031182804018,1676.5,335,1873,1538,5023125
PI565121,1891.9166796143513,1967.5,73,2300,2227,4452471
PI533950,850.8219944933354,870,378,907,529,2591143
PI533950,880.4130979507099,895,11,1027,1016,1933264
PI533950,695.604248366013,693,318,785,467,2126259
SC1120,801.1849821383237,793,2,1009,1007,2353312
SC1120,691.1916427986907,782,3,850,847,887586
SC1120,1378.6666018576848,1480,4,1553,1549,2428557
PI534095,805.0468148992529,839,266,939,673,2428175
PI534095,742.1477665745222,771,2,891,889,1811540
PI534095,803.7182030026826,867,2,1075,1073,2174105
PI597977,167.89747747747748,176,59,179,120,12507
PI597977,379.98560775540636,406,13,462,449,774565
PI597977,322.3569850792186,348,3,423,420,577865
PI533976,1434.3797385620915,1456,1238,1511,273,4375709
PI533976,1185.4303223430045,1192,455,1263,808,3615653
PI533976,1446.4686770131993,1537,520,1679,1159,4308547
PI533864,697.4624043715847,704,12,785,773,1665130
PI533864,640.5694467061436,653,3,770,767,1690376
PI533864,1062.6876308133901,1132,4,1264,1260,2833012
PI656078,1022.9170096415787,1056,3,1186,1183,2941702
PI656078,1567.1102176150266,1566,600,1727,1127,4545330
PI656078,873.1644553432388,900,2,972,970,2562123
PI656028,1211.4356209150326,1231,801,1307,506,3701387
PI656028,919.2372886421037,913,484,1051,567,2803019
PI656028,1685.291507512096,1701,1037,1762,725,4893877
PI533997,989.0787581699346,1003,682,1134,452,3023307
PI533997,781.4339490354499,799,339,881,542,2387199
PI533997,1050.1183006535948,1071,903,1128,225,3213111
PI534128,1219.5841583297954,1239,2,1655,1653,2747113
PI534128,1670.8503267973856,1772,92,1930,1838,5072114
PI534128,1549.74382321318,1767,3,1944,1941,4224006
PI655997,1436.3464638919354,1499,5,1691,1686,3869713
PI655997,1506.8644054119022,1560,645,1698,1053,3965232
PI655997,442.2661406025825,500,3,641,638,86707
PI534139,1316.7256684232123,1435,3,1621,1618,3444684
PI534139,500.82870651204286,567,6,639,633,593091
PI534139,989.007711921442,982,398,1228,830,2875281
PI576393,953.9029411764707,989,757,1313,556,2892205
PI576393,1026.8450980392158,1039,844,1132,288,3140752
PI576393,1135.5179738562092,1148,978,1262,284,3469249
PI576418,1033.400900703789,1055,322,1172,850,3108127
PI576418,1189.8535947712417,1173,982,1309,327,3640380
PI576418,1185.8633986928103,1188,930,1304,374,3622633
PI576329,335.8382462281093,381,8,449,441,249476
PI576329,1195.5712418300654,1237.5,892,1314,422,3650981
PI533955,1339.4693032829427,1364,85,1633,1548,4057444
PI533955,1186.269721359601,1266,2,1457,1455,2297809
PI533955,1176.8211015290558,1175,406,1293,887,3582333
PI576336,839.7151163148785,866,3,968,965,1765036
PI576336,1144.932679738562,1159,874,1338,464,3501316
PI576336,1435.8176470588237,1432,1121,1655,534,4382795
PI576430,1057.241503267974,1102.5,742,1183,441,3230612
PI576430,894.9324675324676,949.5,2,1081,1079,1868042
PI576430,826.3359468723222,881,2,1024,1022,980435
PI533998,474.3033666046354,523,3,654,651,361392
PI533998,255.58158520870447,273,2,387,385,161740
PI533998,638.5553730569134,649.5,3,800,797,857799
SC0191,454.433149353324,499,2,586,584,363929
SC0191,1151.8675252983162,1236,2,1318,1316,2531460
PI533847,933.5826797385621,945,740,1051,311,2856388
PI533847,1266.1165792899997,1293,492,1420,928,3775264
PI533847,1127.4330065359477,1135,1006,1247,241,3449218
PI533931,864.8888888888889,884,650,985,335,2635566
PI533931,879.8277777777778,891,684,994,310,2688234
PI533931,1103.1156360759974,1267,215,1394,1179,3058991
PI576402,1761.3934640522875,1788,1080,2006,926,5377151
PI576402,970.2970588235294,1003,647,1245,598,2963266
PI576402,1602.6186274509805,1576,904,1930,1026,4883107
PI656079,1425.5614379084968,1472,972,1666,694,4351811
PI656079,906.3711937406541,912,415,1023,608,2644042
PI656079,1169.1140522875817,1155,837,1417,580,3566580
BTx645,1316.998209097582,1387,596,1500,904,3891398
BTx645,1562.526797385621,1564.5,1324,1731,407,4771571
BTx645,2034.9797385620916,2029,1287,2271,984,6208736
PI595710,923.2738562091504,925,790,1044,254,2823012
PI595710,1884.4552287581698,1891,1550,2061,511,5762972
PI595710,1821.9928104575165,1818,1588,2023,435,5564531
SC0236,1514.0039215686274,1497,1232,1743,511,4610657
SC0236,1683.009477124183,1679,245,2056,1811,4914272
SC0236,1632.7111111111112,1657,1333,1867,534,4986278
PI533797,1397.4950980392157,1396,606,1627,1021,4268543
PI533797,1818.385294117647,1804,1548,2025,477,5559595
PI533797,1377.5238562091504,1371,857,1699,842,4189559
PI533803,662.7764705882353,657,482,784,302,2027582
PI533803,404.8362091503268,412,292,455,163,977671
PI533803,916.5382352941176,911,521,1126,605,2733733
PI533871,1166.4748366013073,1167,904,1234,330,3558267
PI533871,949.9132308845576,1022.5,5,1160,1155,473766
PI533871,1467.938818667963,1491.5,561,1707,1146,3875757
PI533909,599.4751297577855,634,2,718,716,612449
PI576362,1358.2740515038631,1375,2,1620,1618,3563217
PI576362,1502.7585223770288,1585,7,1677,1670,3990939
PI576362,1700.3973187686197,1773,643,1902,1259,5128969
PI533967,1361.171741342282,1378,3,1569,1566,3492019
PI533967,1238.482120109626,1283,3,1604,1601,2913944
PI533967,1029.2760361552027,1158,2,1295,1293,1231849
PI534141,1363.8175392074254,1388,2,1503,1501,3457119
PI534141,1181.2954248366013,1184,907,1305,398,3608969
PI534141,1166.1522875816993,1183,884,1412,528,3554635
PI534101,1522.2861429236657,1589,3,1699,1696,2857564
PI534101,691.8715693902666,739,3,833,830,747352
PI534101,1185.3945374841692,1256.5,3,1365,1362,1468080
SC0521,108.93055555555556,113,16,126,110,7782
SC0521,347.69232821671847,370,2,450,448,257418
PI533854,788.1063782758008,856,3,945,942,1051938
PI533854,752.347021506301,863.5,3,1030,1027,1369062
PI533854,788.2711191431684,827,4,940,936,1029205
PI534011,736.9587276703915,796,2,940,938,616983
PI534011,1407.6520550132286,1512,2,1596,1594,908143
PI534011,1211.9632734255845,1303,2,1429,1427,1913398
PI534011,1051.8930902956504,1153,3,1247,1244,892727
PI576432,1395.4792672212611,1445.5,3,1628,1625,2750422
PI576432,516.9991768276998,565,6,637,631,426128
PI576363,1444.9297385620916,1468,1069,1612,543,4409601
PI576363,1485.6790849673203,1518.5,1068,1672,604,4521507
PI576363,1201.425816993464,1207,967,1377,410,3670611
SC0713,1362.3176918255886,1395,1101,1423,322,3900266
SC0713,1267.2127450980392,1302,873,1364,491,3828696
SC0713,1019.3408496732026,1045.5,828,1187,359,3093111
PI534050,1255.8833333333332,1263,603,1365,762,3828520
PI534050,1916.517120629232,1933,996,2151,1155,5809218
PI534050,1737.0882352941176,1741.5,1395,1896,501,5297980
PI533795,1100.90486244246,1183,5,1516,1511,1387960
PI533795,987.6610799620645,1031,581,1193,612,2989330
PI533795,1601.3242511919061,1630,468,1908,1440,4833308
SC0409,868.7297334609162,902,2,1007,1005,2209661
SC0409,743.6187195225768,774,2,873,871,1523231
SC0409,483.0452309822209,494,131,517,386,1213967
PI576399,929.6771298309345,936,37,1626,1589,2778665
PI576399,454.61261822754363,449,47,538,491,974125
PI576399,939.8924998635778,977,2,1051,1049,2832293
PI534084,508.5590716898665,523,3,554,551,1215054
PI534084,773.244762683162,840,2,959,957,1337610
PI534084,765.6518120531501,819,2,890,888,1884515
PI656004,1095.2288680531344,1134,4,1538,1534,3226919
PI656004,767.7075163398692,757,320,1383,1063,2341076
PI656004,934.5369467838908,951.5,101,1154,1053,2380324
PI533780,758.3273211692451,780,4,886,882,1728094
PI533780,350.5087403855759,372,23,423,400,615479
PI533780,527.2067141898385,547,2,703,701,869374
PI576372,772.6214162361409,829,2,966,964,1258044
PI576372,1049.5257728057109,1083,3,1148,1145,2731160
PI576372,1388.00256765715,1429,10,1583,1573,3832735
PI656078,581.8713389046815,655,2,766,764,435032
PI656078,822.1161273283292,879.5,2,1057,1055,954284
PI656078,1501.0321745705533,1488,32,1761,1729,4541080
PI533967,180.0682646115441,204.5,4,283,279,64961
PI533967,170.3303980052394,167,2,246,244,78415
PI534003,988.5310706735124,1010,2,1124,1122,2215413
PI534003,385.65502063477925,431,3,559,556,209591
PI656087,1230.6337211163643,1295,227,1699,1472,3564272
PI656087,1625.7606195964017,1654,80,1832,1752,4855785
PI656087,1423.8643276841708,1451,55,1642,1587,4318842
PI534130,841.9829147266488,855,253,1066,813,2541111
PI534130,747.2193144717762,792,4,897,893,1949952
PI534130,1282.8089659995564,1311.5,3,1765,1762,3790172
SC1178,1159.283365334264,1174,176,1282,1106,3513856
SC1178,957.8200269105419,985,9,1114,1105,2907405
SC1178,869.9746253758258,873,62,946,884,2648310
PI576396,506.81140949133277,527,207,571,364,1314468
PI576396,539.7497480099854,547.5,20,587,567,1396879
PI576396,553.1791831357049,550,34,628,594,1427738
PI533922,1246.3639927181157,1267,185,1337,1152,3780846
PI533922,1644.3055729190114,1709,33,1809,1776,5011793
PI533922,1401.5176883928802,1422,49,1625,1576,4164847
PI533940,961.748366013072,977,590,1356,766,2927742
PI533940,957.2509051680232,960,14,1057,1043,2672361
PI533940,1285.3866013071895,1301,795,1404,609,3927609
PI534065,1120.5322836445723,1124,47,1212,1165,3169502
PI534065,909.0151960784314,907,650,1098,448,2533311
PI534065,1053.332817762331,1048,20,1660,1640,3187341
PI534115,1539.2578236269633,1542,1239,1600,361,4438835
PI534115,1690.0303242641244,1693,15,1847,1832,5074063
PI534115,2023.3815367779678,2058,79,2178,2099,6127211
SC0640,1090.0946140755261,1112,64,1209,1145,3320015
SC0640,1334.968160904713,1337.5,652,1636,984,4057345
SC0640,983.0702498423498,999,23,1644,1621,2980433
PI533805,701.5206349206348,725,192,779,587,1902273
PI533805,670.2461251167134,680,128,736,608,1807791
PI533805,771.4883305719019,776,56,860,804,2105188
PI534081,1196.1238656566438,1252,49,1682,1633,3576837
PI534081,950.8083555518142,981,42,1220,1178,2881554
PI534081,940.7876121286538,941,136,1026,890,2858672
PI534066,468.3277155536771,482,4,536,532,1053000
PI534066,926.8201533595144,959,207,1079,872,2646795
PI534066,907.6568532111664,901,5,1151,1146,2395001
PI656043,1271.4745112301007,1279,47,1481,1434,3846759
PI656043,1378.6797385620914,1463,750,1568,818,3967729
PI656043,1310.5421568627453,1384,826,1599,773,3964778
SC1097,1810.44473199908,1842,11,2298,2287,5381101
SC1097,1408.5931372549019,1449,832,1679,847,4301514
SC1097,1768.370623768453,1813,20,1984,1964,5380147
PI533788,1317.992496823598,1367,463,1482,1019,3529254
PI533788,1201.9651065249357,1213,304,1540,1236,3599266
PI534098,988.776902158713,973,549,1114,565,3010075
PI534098,1064.131485782862,1071,45,1485,1440,3240028
PI534098,1305.173202614379,1336,899,1438,539,3988636
PI533845,1350.0624183006535,1367,654,1555,901,4121831
PI533845,1018.833660130719,1033,658,1644,986,3108095
PI533845,1139.8218954248366,1183,410,2035,1625,3419793
PI534112,1283.7513889204179,1294,42,1344,1302,3897510
PI534112,1143.0960784313725,1150,962,1302,340,3494353
PI534112,1167.0519607843137,1187,935,1254,319,3569144
PI576375,1590.5827331289047,1618,50,1730,1680,4807535
PI576375,1403.28249256462,1425,5,1564,1559,4081878
PI576375,1141.523696831886,1150,565,1195,630,3475872
PI534162,1309.3382352941176,1346,942,1519,577,3934762
PI534162,1122.807613640939,1128,142,1270,1128,3342350
PI534162,1287.6724045412077,1411,4,1825,1821,3112859
PI533970,1578.4418584825235,1601,1066,1671,605,4581675
PI533970,1537.3427637721757,1603,345,1716,1371,4460118
PI533970,1604.0016221853155,1640,28,1704,1676,4627849
SC0190,959.8266573295984,987,105,1051,946,2687028
SC0190,882.0884717083973,896,35,1075,1040,2670989
SC0190,1915.7973107678827,1910,43,2191,2148,5794360
PI533779,662.7859962406014,667,70,722,652,1776279
PI533779,696.8064658201752,688,35,792,757,1887941
PI533779,474.20587264929065,509,37,568,531,1203756
PI656080,1322.116482717021,1322,232,1456,1224,4018548
PI656080,706.1011677488129,689,23,864,841,1899951
PI656080,829.2760228640193,849,63,908,845,2281088
PI533924,1174.6318831430951,1188,64,1399,1335,3582550
PI533924,1189.8050033806626,1129,438,1497,1059,3621311
PI533924,1266.2889018010137,1370,3,1444,1441,1871703
PI576433,1424.85539248622,1443,674,1620,946,4333918
PI576433,1418.7512967610387,1458.5,6,1781,1775,4287344
PI576433,1670.0851651975777,1687.5,35,1849,1814,5094468
PI533992,1258.9141671082848,1274,590,1414,824,3483769
PI533992,1359.5814045787915,1357,358,2070,1712,4137236
PI533992,1535.8027997796646,1571,40,1615,1575,4448396
PI576395,1645.2532713836654,1651,35,2270,2235,4992757
PI576395,1149.186022183371,1185,51,1355,1304,3208821
PI576395,972.5590389770496,1008,314,1086,772,2710992
PI533907,1757.628463622291,1789,125,1877,1752,5072681
PI533907,2244.9636012151336,2244,1172,2453,1281,6599288
PI533907,1606.4864626025817,1605,41,1821,1780,4588536
SC0179,1208.0425619641098,1264,32,1293,1261,3441339
SC0179,1025.712044035491,1025,59,1123,1064,2880061
SC0179,957.4161531279178,952,285,1188,903,2689113
PI656084,981.9764631043256,1065,407,1776,1369,2460036
PI656084,1426.6326450685056,1409,587,2536,1949,4288951
PI656084,1161.5353159041395,1219.5,135,1633,1498,3326829
PI609456,1093.315597007886,1086,341,1576,1235,3296417
PI609456,953.2602027407061,969,2,1051,1049,2618320
PI609456,934.5940325155728,1003,2,1060,1058,1592057
PI534047,683.6434953895343,646,31,817,786,1841334
PI534047,1012.0222222222221,1016,817,1140,323,3090754
PI534047,757.7495143087905,756,7,1004,997,2202192
PI576365,1182.2217156773038,1291,2,1412,1410,2748380
PI576365,1002.9678547308074,1013,448,1143,695,3008176
PI576365,885.4220184075893,937,4,1025,1021,1993463
PI597969,872.4941255889363,874,49,967,918,2644190
PI597969,717.6997334501771,716,62,1031,969,2152337
PI597969,1231.8449369107182,1206,317,1524,1207,3620017
PI595708,791.8060694986581,826,4,900,896,2147506
PI595708,705.0200714603368,681,2,1186,1184,1517985
PI595708,423.80218253007837,453,5,510,505,790500
PI533865,908.6079899626245,945,3,996,993,1813518
PI533865,809.6919134989953,842,2,920,918,2029124
PI533865,1046.7303048824135,1088,48,1161,1113,2796854
PI534092,279.3036908790431,315.5,4,334,330,44209
PI534092,570.3507076383455,573,3,945,942,367180
PI534092,802.1841366487924,843,3,1001,998,1451245
PI656007,930.866639445747,970,2,1168,1166,2244604
PI656007,211.9596899224806,234,31,268,237,87988
PI656007,349.34653963652465,392,3,500,497,257324
PI533995,723.4249507111674,739.5,3,894,891,1496475
PI533995,1325.1765365873425,1364,26,1567,1541,2754166
PI595746,656.0772928526249,740,2,845,843,546773
PI595729,433.3691775482363,528,3,645,642,201301
PI534035,1037.177025011349,1125,3,1298,1295,934093
PI534035,1005.7995683679309,1053,3,1400,1397,2245711
PI534035,227.77659574468086,268,3,318,315,49219
PI656088,818.1130933882371,892,3,1085,1082,471754
PI656088,482.05136016476445,555,3,634,631,420678
PI576358,1011.1438981728227,1104,3,1235,1232,1270332
PI576358,148.51181369168987,164.5,2,224,222,131363
SC0041,751.796852839873,800,2,943,941,528772
SC0041,1340.7277975737804,1377,17,1594,1577,3958391
PI597980,386.968586108954,411,2,593,591,294671
PI576435,630.3496678281068,681,4,811,807,663456
PI576435,634.4276381620381,625,2,856,854,1158722
PI576435,446.94710100165935,486,4,599,595,808950
PI576389,623.2252059485327,696,2,767,765,633624
PI576389,701.9913776048825,744,2,904,902,1062928
PI576389,752.9717059306357,833,2,938,936,1075913
SC0249,1471.0734506654067,1513,189,1678,1489,4287506
SC0249,825.2031611482298,825,34,915,881,2263255
SC0249,1085.474669241365,1125,2,1277,1275,2468183
PI534056,1416.7131844316673,1505,3,1696,1693,3386192
PI534056,1091.5213183158062,1142.5,4,1235,1231,2392417
PI534056,1027.049500822778,1068,4,1129,1125,2808733
PI534132,1394.5638830532212,1407,132,1644,1512,3162745
PI534132,958.03888248925,979,2,1190,1188,2198456
PI534132,1567.9470515290757,1678,2,1766,1764,3255352
PI656113,622.9822904456456,646.5,2,821,819,1548653
PI656113,1007.7868117041909,1039,4,1379,1375,2507224
PI656113,136.97354580598758,153,4,165,161,28163
SC0448,2039.1588235294116,2072,1251,2270,1019,6228940
SC0448,769.4325725192994,802,22,985,963,1635162
PI595703,1852.6199394772452,1971,11,2159,2148,4917148
PI595703,1832.3352941176468,1856,741,2113,1372,5572257
PI595703,833.61216130764706,838,29,905,876,2532484
PI597974,100.03586904188734,105,21,120,99,6547
PI533753,1121.6707265921414,1127,32,1349,1317,3415688
PI533753,889.6426207598254,910,392,1002,610,2706005
PI533753,899.1218527990906,921,738,975,237,2466222
SC0027,1481.5412311491075,1495,241,1694,1453,4507383
SC0027,1476.7058698557014,1489,68,1609,1541,4471160
SC0027,1416.193083494385,1399.5,210,1639,1429,4299947
PI534057,1399.8032981074734,1448,61,1609,1548,4253931
PI534057,807.8081699346405,819,497,952,455,2469343
PI534057,1988.0813725490195,2023,280,2230,1950,6009259
PI656092,1553.94642380085,1530,85,1748,1663,4738091
PI656092,1542.1543381183278,1576,17,1695,1678,4672262
PI656092,1728.3266152351025,1797,82,1922,1840,5243852
